#module 0 size: 32 bs: 0.000901786
1 124 169 192 206 211 222 249 310 320 339 340 341 355 364 374 392 451 460 474 483 503 507 516 524 558 571 572 589 623 633 639 
#module 1 size: 30 bs: 2.23161e-06
5 48 115 137 197 236 243 244 261 267 276 292 301 336 347 368 381 389 470 486 490 497 520 566 587 651 657 665 693 697 
#module 2 size: 23 bs: 0.00426368
103 148 173 177 180 188 199 219 221 238 297 302 304 312 324 348 353 376 453 472 518 521 547 
#module 3 size: 21 bs: 0.00133134
7 22 47 63 104 112 138 216 229 268 295 311 319 379 388 405 419 433 444 619 685 
#module 4 size: 20 bs: 2.52702e-06
67 73 86 94 97 102 148 197 293 306 310 326 383 406 407 410 428 474 509 528 
#module 5 size: 15 bs: 0.000740686
11 14 16 32 64 65 74 77 80 87 95 113 222 353 553 
#module 6 size: 21 bs: 0.000478243
26 53 69 77 79 135 143 146 147 178 183 212 217 277 365 396 445 462 479 492 508 
#module 7 size: 39 bs: 9.40771e-06
6 30 46 81 88 114 117 126 136 145 152 160 165 179 204 234 273 335 432 437 438 458 463 478 498 526 541 551 564 566 570 575 608 630 632 637 675 688 695 
#module 8 size: 35 bs: 0.000662228
20 25 38 44 54 70 78 140 183 233 241 282 303 329 330 356 419 434 439 459 477 491 509 531 546 568 574 582 586 601 603 646 662 675 689 
#module 9 size: 27 bs: 3.91353e-05
105 167 220 228 245 252 266 271 296 313 338 349 351 363 369 414 435 471 536 553 577 579 583 595 604 640 699 
#module 10 size: 20 bs: 0.000617249
10 24 28 34 72 89 148 150 171 201 239 269 283 299 307 308 332 383 488 583 
#module 11 size: 32 bs: 0.000479843
23 41 68 156 158 177 182 215 237 254 264 274 299 300 337 359 380 408 464 473 474 483 487 514 515 527 588 598 629 652 661 685 
#module 12 size: 25 bs: 1.31705e-06
2 123 203 254 288 302 315 352 371 425 436 488 525 549 567 609 631 647 650 652 654 660 671 672 676 
#module 13 size: 27 bs: 0.00270646
15 25 40 56 138 172 190 195 272 302 366 393 399 408 409 412 431 514 528 545 548 599 615 643 666 682 686 
#module 14 size: 34 bs: 3.87046e-05
31 70 101 106 214 232 243 254 268 314 324 328 341 343 372 378 398 413 417 455 475 510 532 552 573 584 606 619 620 626 627 641 664 690 
#module 15 size: 39 bs: 0.00205813
59 62 82 84 85 92 100 143 155 163 176 178 225 249 270 273 277 281 318 342 343 375 382 383 386 387 411 425 441 484 491 495 508 545 576 619 624 652 696 
#module 16 size: 35 bs: 0.000521486
21 107 120 142 162 177 178 193 218 260 278 336 344 381 404 422 439 466 482 483 500 509 534 538 545 560 594 597 601 616 649 663 674 678 679 
#module 17 size: 36 bs: 0.00446275
93 108 119 122 186 187 191 211 259 265 291 298 310 333 358 391 398 414 416 418 424 440 449 462 539 544 559 563 625 631 638 654 675 681 698 699 
#module 18 size: 20 bs: 0.00399508
33 66 90 99 125 138 140 224 257 275 280 286 294 320 341 397 447 454 489 687 
#module 19 size: 21 bs: 1.00228e-06
12 42 58 174 198 208 249 289 316 331 384 395 421 480 481 499 501 505 542 579 583 
#module 20 size: 36 bs: 1.80992e-05
3 13 27 36 37 57 91 111 129 134 139 157 164 206 219 223 317 334 359 361 394 427 442 450 494 496 529 581 592 611 613 614 621 656 659 700 
#module 21 size: 29 bs: 0.00231881
43 45 49 76 132 175 248 343 354 357 381 401 446 469 476 555 561 565 566 586 602 607 618 628 645 668 677 687 691 
#module 22 size: 24 bs: 2.49193e-05
151 200 210 235 243 247 322 325 361 400 415 462 468 485 508 522 523 540 554 580 647 648 663 684 
#module 23 size: 37 bs: 0.000223556
61 127 130 134 153 166 184 229 253 284 305 309 323 324 390 402 423 457 491 522 533 535 537 550 556 578 590 610 631 644 647 653 655 672 673 683 685 
#module 24 size: 32 bs: 0.000443025
9 18 50 53 96 98 110 194 207 211 219 258 295 360 385 414 419 425 430 443 452 461 465 499 503 513 514 530 557 585 591 617 
#module 25 size: 27 bs: 7.53382e-05
55 93 131 154 168 205 209 229 251 255 273 285 321 346 363 367 439 456 499 503 517 519 528 569 642 681 694 
#module 26 size: 36 bs: 0.00118261
24 39 51 52 71 141 160 161 164 169 183 189 196 213 222 230 242 262 263 264 277 327 336 350 359 362 370 409 467 504 512 543 553 562 635 692 
#module 27 size: 37 bs: 0.000137572
8 109 116 121 149 170 181 185 197 202 206 227 231 256 268 279 287 290 295 353 398 409 426 488 502 511 522 579 586 600 605 634 636 667 669 672 681 
#module 28 size: 24 bs: 0.000265923
75 77 113 118 133 144 150 159 164 171 226 257 377 401 403 448 464 493 596 654 658 663 680 699 
#module 29 size: 29 bs: 0.00471311
17 28 29 35 60 83 128 155 240 246 247 250 320 345 361 373 401 408 420 429 464 506 593 601 612 622 670 687 698 
