#module 0 size: 18 bs: 1.3498e-07
17 66 90 118 196 253 357 363 374 468 487 490 566 576 584 664 677 686 
#module 1 size: 30 bs: 4.52128e-05
105 111 124 128 160 181 242 243 279 292 307 309 335 340 372 390 438 459 463 484 499 520 563 607 618 634 638 669 670 680 
#module 2 size: 27 bs: 0.00247567
67 97 99 114 172 192 209 244 262 309 321 326 354 418 422 469 474 493 496 503 523 547 573 574 649 672 676 
#module 3 size: 20 bs: 0.000141857
9 36 55 174 234 240 254 294 306 376 392 459 508 512 557 559 606 627 651 698 
#module 4 size: 23 bs: 0.00286263
1 15 24 117 135 158 271 278 291 316 317 322 358 400 417 427 429 456 509 514 535 538 543 
#module 5 size: 33 bs: 0.000338322
5 56 81 116 162 170 197 201 220 226 314 323 344 346 368 384 426 460 471 494 522 528 536 570 578 590 593 604 633 645 654 657 660 
#module 6 size: 15 bs: 0.00200758
3 13 71 93 132 281 320 333 337 414 549 554 565 670 689 
#module 7 size: 33 bs: 0.000262035
4 11 138 152 180 193 225 228 231 236 237 284 289 304 315 405 408 410 442 449 458 489 510 517 518 527 535 568 596 612 651 653 654 
#module 8 size: 31 bs: 0.000808275
25 32 75 82 100 122 148 163 178 217 274 275 309 337 350 361 373 402 466 478 491 521 522 537 577 582 633 637 640 643 699 
#module 9 size: 39 bs: 0.00033689
16 22 53 68 106 123 136 139 146 154 156 213 227 235 239 252 261 313 316 339 342 343 352 421 434 439 462 464 492 495 509 560 595 644 652 659 662 693 700 
#module 10 size: 26 bs: 0.00322261
10 63 204 212 233 248 268 277 298 313 317 318 328 331 353 375 453 480 519 524 542 548 599 615 642 674 
#module 11 size: 29 bs: 0.000799125
18 19 44 62 72 150 255 271 303 312 347 376 404 407 413 446 465 470 473 501 502 507 556 591 595 598 613 639 656 
#module 12 size: 30 bs: 0.00124554
58 84 109 131 149 173 198 203 205 207 256 302 327 371 378 443 534 540 551 556 560 592 597 636 646 658 661 663 667 691 
#module 13 size: 21 bs: 5.86355e-05
6 45 77 92 127 186 223 250 270 334 367 394 423 448 455 520 526 532 544 556 617 
#module 14 size: 26 bs: 0.000252048
26 33 39 57 72 87 88 95 108 165 168 175 176 187 189 264 283 393 436 517 532 603 621 633 668 681 
#module 15 size: 23 bs: 1.67688e-06
8 76 96 125 137 295 300 329 332 349 399 411 475 497 500 511 541 546 558 575 580 682 696 
#module 16 size: 21 bs: 0.00281607
35 49 83 119 126 195 230 251 263 287 297 299 368 370 377 416 419 508 619 626 684 
#module 17 size: 12 bs: 7.0267e-09
12 28 29 129 144 356 362 379 479 504 581 601 
#module 18 size: 26 bs: 0.00137439
34 50 112 133 145 177 179 185 212 238 241 266 305 325 360 457 491 535 550 564 624 631 636 670 671 697 
#module 19 size: 28 bs: 9.01926e-05
43 65 166 216 232 238 246 258 313 335 345 348 353 382 386 387 391 410 417 425 451 467 499 505 533 536 589 608 
#module 20 size: 28 bs: 0.000733546
89 101 104 202 221 267 293 301 338 351 353 365 366 378 405 416 433 476 516 518 532 555 579 583 611 629 663 683 
#module 21 size: 17 bs: 0.00324684
60 64 147 182 191 206 211 395 506 520 525 529 614 623 641 687 690 
#module 22 size: 22 bs: 0.000998053
27 69 130 151 215 222 224 260 285 364 430 440 444 530 571 577 587 594 623 655 666 679 
#module 23 size: 36 bs: 0.0038375
31 37 70 110 113 155 164 183 184 186 194 257 269 282 324 341 383 397 431 439 445 448 450 481 486 513 567 586 588 600 628 630 647 648 658 694 
#module 24 size: 33 bs: 0.00353541
14 59 65 78 86 98 121 142 153 188 214 227 229 288 330 380 385 388 398 405 407 420 441 483 485 540 646 650 661 663 669 675 685 
#module 25 size: 30 bs: 0.00115441
41 73 79 80 159 167 210 310 319 359 401 403 406 424 428 430 435 447 454 472 473 491 569 577 610 620 625 635 646 695 
#module 26 size: 28 bs: 0.00421839
21 24 30 51 91 103 115 141 157 161 200 208 212 219 232 249 280 344 396 410 412 452 515 517 561 562 586 690 
#module 27 size: 30 bs: 0.00405102
2 7 20 42 74 86 102 120 169 190 199 208 257 259 276 286 296 336 355 368 369 409 437 448 461 477 488 539 621 622 
#module 28 size: 27 bs: 0.000350408
47 134 218 245 247 265 272 290 311 316 317 381 389 415 432 482 498 531 552 572 586 602 605 609 632 678 688 
#module 29 size: 17 bs: 0.00217374
54 61 121 171 273 308 544 545 552 553 585 593 595 616 665 673 692 
