#module 0 size: 35 bs: 6.11396e-06
16 124 224 261 414 465 510 533 615 617 658 700 737 819 949 962 963 970 997 1029 1034 1092 1105 1157 1198 1229 1252 1275 1278 1341 1387 1414 1418 1441 1472 
#module 1 size: 18 bs: 2.89587e-05
13 56 67 110 152 229 232 260 265 288 316 335 409 428 469 500 930 1061 
#module 2 size: 35 bs: 1.92694e-05
6 17 37 70 167 191 332 360 398 502 558 578 591 613 681 685 828 844 899 938 966 979 985 1022 1051 1082 1135 1147 1196 1208 1240 1265 1279 1361 1483 
#module 3 size: 26 bs: 0.000820847
454 477 493 577 589 650 675 834 859 1037 1101 1113 1132 1137 1150 1217 1231 1256 1261 1262 1328 1385 1401 1424 1440 1487 
#module 4 size: 20 bs: 3.74233e-05
80 102 200 327 370 383 386 453 514 553 666 682 781 820 930 950 1003 1043 1306 1377 
#module 5 size: 25 bs: 0.000264881
42 174 202 230 626 637 663 695 829 838 897 910 1042 1082 1091 1117 1120 1187 1204 1213 1296 1385 1437 1455 1498 
#module 6 size: 34 bs: 0.00456264
5 132 241 452 594 608 641 671 680 699 809 824 872 981 1057 1061 1093 1096 1125 1263 1284 1292 1308 1317 1329 1338 1359 1364 1376 1383 1390 1418 1461 1493 
#module 7 size: 31 bs: 0.00243216
7 110 150 167 290 292 301 354 385 443 533 551 559 575 752 770 842 946 975 1008 1025 1084 1134 1146 1156 1168 1201 1205 1333 1411 1494 
#module 8 size: 34 bs: 0.000128531
59 89 195 373 402 410 414 431 484 506 528 539 640 683 747 799 853 871 965 982 1076 1087 1180 1266 1282 1299 1316 1321 1333 1337 1363 1382 1435 1480 
#module 9 size: 24 bs: 0.000902706
147 196 317 429 482 701 738 744 757 785 786 802 842 851 904 973 1030 1089 1205 1244 1254 1348 1350 1406 
#module 10 size: 18 bs: 6.21148e-06
99 119 226 267 419 481 513 549 613 639 642 647 727 1138 1306 1315 1430 1446 
#module 11 size: 19 bs: 1.76179e-06
12 101 278 285 320 338 357 397 479 514 569 586 632 694 801 868 1156 1278 1390 
#module 12 size: 32 bs: 7.2421e-09
25 121 294 300 372 412 456 530 561 587 615 665 687 750 774 821 855 923 957 1006 1071 1085 1119 1129 1192 1238 1312 1323 1325 1405 1413 1426 
#module 13 size: 23 bs: 0.00453383
38 281 296 322 438 478 526 542 634 739 888 895 904 911 947 1040 1139 1214 1315 1343 1371 1422 1468 
#module 14 size: 21 bs: 1.10275e-05
28 184 354 382 426 470 477 518 550 619 898 989 1007 1017 1035 1044 1196 1210 1226 1227 1366 
#module 15 size: 25 bs: 9.07075e-05
27 39 68 91 168 435 532 602 684 696 714 722 798 921 952 956 970 974 1026 1078 1107 1150 1199 1495 1499 
#module 16 size: 20 bs: 0.000290375
19 120 127 142 176 214 380 437 538 604 622 741 749 772 789 827 837 1268 1338 1454 
#module 17 size: 16 bs: 0.000172632
32 36 69 145 155 190 208 269 289 337 457 597 811 828 1281 1342 
#module 18 size: 31 bs: 0.00442719
21 81 199 217 298 323 363 376 470 483 540 565 630 631 648 766 768 835 913 964 1062 1130 1144 1249 1300 1353 1369 1378 1398 1476 1488 
#module 19 size: 39 bs: 0.00283975
46 49 103 129 133 134 142 172 367 467 556 563 571 733 795 894 917 927 939 953 996 1013 1065 1090 1148 1156 1161 1186 1195 1248 1297 1309 1334 1360 1373 1390 1410 1481 1486 
#module 20 size: 40 bs: 0.00116649
109 142 167 234 252 280 311 341 390 395 425 452 497 567 579 588 624 667 677 734 759 804 832 836 892 906 1023 1048 1167 1233 1236 1289 1389 1402 1434 1439 1442 1463 1495 1496 
#module 21 size: 18 bs: 2.94266e-05
182 225 244 249 361 369 421 529 657 673 1077 1089 1118 1238 1241 1370 1425 1468 
#module 22 size: 20 bs: 0.000506241
169 173 201 204 255 256 318 418 439 468 519 564 583 654 664 689 924 1093 1312 1349 
#module 23 size: 22 bs: 4.27266e-07
111 114 253 331 343 570 856 864 865 873 886 913 923 925 1022 1103 1126 1139 1215 1302 1322 1389 
#module 24 size: 28 bs: 0.00463041
138 456 524 597 626 686 691 722 785 924 941 942 958 971 994 1060 1069 1079 1133 1159 1183 1221 1278 1326 1356 1417 1445 1460 
#module 25 size: 19 bs: 4.71104e-05
73 146 257 273 284 358 610 636 659 689 875 893 896 929 933 944 1255 1268 1329 
#module 26 size: 19 bs: 0.000448137
64 82 87 96 212 292 387 432 456 461 466 561 574 606 665 897 1093 1182 1383 
#module 27 size: 22 bs: 0.000189055
33 169 215 242 291 295 494 515 709 735 766 846 851 947 1039 1099 1169 1198 1287 1418 1427 1500 
#module 28 size: 36 bs: 1.4785e-06
51 84 100 319 366 394 406 467 665 678 718 720 721 732 764 777 792 807 828 830 845 935 936 1057 1073 1133 1153 1188 1223 1263 1274 1319 1320 1448 1456 1479 
#module 29 size: 19 bs: 8.44766e-08
83 148 330 408 416 492 511 527 537 584 676 688 692 812 943 1008 1118 1224 1425 
#module 30 size: 36 bs: 6.27728e-07
45 116 117 130 166 206 276 294 403 499 535 582 605 778 803 822 867 876 891 914 999 1056 1154 1165 1179 1206 1224 1237 1272 1385 1391 1426 1435 1453 1454 1468 
#module 31 size: 24 bs: 0.00205273
161 187 220 263 302 374 493 522 635 708 728 823 862 988 1157 1256 1296 1301 1349 1380 1396 1462 1467 1491 
#module 32 size: 20 bs: 0.000979941
66 198 205 211 332 333 352 464 489 540 651 660 703 751 764 767 878 927 1223 1426 
#module 33 size: 32 bs: 0.000260143
92 303 361 451 545 562 618 632 689 711 779 787 804 816 843 877 912 919 920 950 1033 1075 1118 1143 1293 1303 1335 1420 1429 1440 1447 1477 
#module 34 size: 37 bs: 3.22127e-05
85 188 247 307 422 457 503 531 614 669 715 756 783 870 908 932 933 941 946 947 969 1011 1021 1055 1077 1089 1140 1165 1190 1222 1272 1277 1315 1331 1349 1412 1470 
#module 35 size: 29 bs: 0.00348658
3 34 58 164 266 283 308 379 407 458 613 615 666 687 748 849 857 992 1009 1036 1212 1250 1294 1312 1368 1375 1419 1425 1494 
#module 36 size: 27 bs: 7.68124e-05
55 136 194 236 359 392 430 435 496 620 653 674 681 697 741 978 1025 1028 1031 1057 1095 1190 1207 1270 1286 1443 1491 
#module 37 size: 38 bs: 2.54235e-05
94 97 233 240 254 297 298 315 325 359 362 393 424 495 557 609 621 648 712 916 956 1014 1022 1068 1075 1112 1131 1174 1185 1187 1208 1223 1255 1271 1324 1395 1399 1473 
#module 38 size: 23 bs: 7.95583e-05
160 327 370 388 446 547 597 600 609 703 765 808 839 885 980 1038 1058 1166 1189 1218 1338 1394 1485 
#module 39 size: 18 bs: 0.00085996
43 74 171 197 209 210 389 413 504 561 607 643 969 1149 1275 1319 1352 1494 
#module 40 size: 17 bs: 0.000192274
2 23 44 75 144 178 193 264 324 359 420 434 467 768 855 898 918 
#module 41 size: 33 bs: 5.83825e-05
18 57 72 107 140 223 274 395 396 399 460 566 593 629 714 719 758 760 782 855 874 894 915 956 1145 1205 1210 1322 1351 1358 1432 1491 1493 
#module 42 size: 27 bs: 0.000661063
48 90 169 240 299 350 353 411 512 516 603 632 668 723 726 882 901 946 1001 1009 1015 1117 1200 1339 1347 1405 1428 
#module 43 size: 39 bs: 0.00119297
11 24 60 118 144 147 151 170 172 199 286 304 356 364 404 407 447 452 457 505 508 512 536 568 595 753 794 894 1041 1106 1109 1114 1165 1257 1269 1318 1397 1408 1466 
#module 44 size: 34 bs: 4.97016e-05
41 52 65 113 185 199 224 270 272 365 371 375 378 444 554 555 655 721 736 821 833 849 866 869 943 944 1204 1296 1336 1352 1357 1405 1483 1484 
#module 45 size: 37 bs: 0.00105088
22 116 154 170 175 326 391 414 435 711 724 729 731 772 788 903 948 967 987 1018 1032 1053 1059 1061 1086 1115 1151 1162 1182 1243 1298 1327 1370 1388 1403 1450 1500 
#module 46 size: 38 bs: 0.00350213
62 239 240 259 436 440 449 463 616 633 640 678 719 721 796 800 878 887 909 926 953 972 983 1000 1030 1098 1116 1136 1138 1152 1191 1284 1290 1310 1352 1355 1358 1423 
#module 47 size: 15 bs: 0.000304834
14 35 104 115 131 232 245 246 258 304 477 819 924 1423 1495 
#module 48 size: 38 bs: 3.33525e-05
9 156 158 261 340 422 462 471 472 478 521 535 601 612 621 623 644 700 772 818 826 842 848 861 897 933 1001 1111 1163 1202 1220 1273 1308 1311 1330 1346 1381 1444 
#module 49 size: 38 bs: 3.81029e-05
195 237 238 262 346 351 361 375 441 474 573 621 646 652 691 742 754 821 840 854 918 984 993 1054 1074 1094 1111 1230 1235 1240 1259 1271 1311 1391 1396 1409 1421 1430 
#module 50 size: 27 bs: 0.000198814
105 137 177 227 228 248 347 381 450 548 725 730 755 768 831 883 900 1070 1117 1150 1246 1311 1354 1377 1420 1433 1465 
#module 51 size: 35 bs: 2.68459e-05
29 151 189 207 214 427 458 490 501 548 609 710 743 745 762 863 887 951 953 978 1019 1141 1163 1281 1293 1308 1342 1384 1391 1392 1404 1407 1415 1431 1469 
#module 52 size: 20 bs: 0.0028055
203 313 332 373 445 546 592 611 703 761 780 830 850 883 892 976 1107 1135 1472 1500 
#module 53 size: 33 bs: 4.15504e-05
139 163 243 254 470 535 608 628 719 766 814 833 841 903 905 913 914 1012 1102 1182 1264 1304 1314 1322 1340 1344 1379 1400 1416 1435 1452 1458 1472 
#module 54 size: 34 bs: 0.00191726
15 50 78 149 159 291 321 355 399 405 442 645 664 691 700 784 790 904 978 1064 1070 1076 1108 1211 1232 1247 1271 1284 1305 1307 1393 1396 1458 1489 
#module 55 size: 22 bs: 0.000970603
180 349 599 623 625 698 878 927 969 974 976 977 1016 1025 1052 1070 1086 1144 1145 1194 1455 1464 
#module 56 size: 36 bs: 1.93074e-05
157 250 271 305 306 336 370 417 455 517 534 623 640 679 716 722 810 817 822 883 884 926 945 1097 1143 1144 1193 1196 1201 1253 1272 1283 1292 1333 1423 1474 
#module 57 size: 33 bs: 3.87897e-05
71 86 181 298 345 473 476 572 580 585 648 808 922 923 926 939 991 1011 1020 1046 1076 1133 1143 1178 1210 1216 1225 1240 1267 1372 1430 1449 1455 
#module 58 size: 19 bs: 2.52379e-05
31 53 126 135 147 235 268 275 329 400 480 543 544 711 888 963 1389 1419 1467 
#module 59 size: 31 bs: 0.00494944
26 598 626 662 666 693 717 741 746 805 819 890 998 1077 1081 1082 1104 1122 1149 1153 1155 1160 1198 1345 1358 1365 1374 1459 1478 1488 1492 
#module 60 size: 33 bs: 0.00203029
192 242 279 314 368 448 475 485 509 520 638 687 723 815 852 937 995 996 1005 1045 1110 1145 1219 1224 1241 1255 1256 1281 1343 1346 1439 1488 1490 
#module 61 size: 36 bs: 0.00266519
95 213 328 498 526 533 552 726 727 793 804 813 822 851 880 892 930 935 944 1024 1030 1049 1100 1107 1124 1158 1176 1258 1276 1288 1313 1332 1366 1367 1447 1482 
#module 62 size: 32 bs: 0.00183476
40 88 222 287 309 342 348 399 423 459 670 704 707 714 791 808 860 941 990 1008 1010 1050 1066 1122 1181 1209 1263 1292 1366 1447 1454 1471 
#module 63 size: 19 bs: 0.00100921
54 108 143 179 231 252 293 491 523 541 580 608 652 664 806 1241 1293 1335 1420 
#module 64 size: 23 bs: 0.00134161
10 63 401 415 494 733 898 939 943 996 1002 1142 1153 1164 1203 1228 1239 1275 1335 1342 1377 1415 1438 
#module 65 size: 31 bs: 3.55999e-06
8 125 186 339 384 422 433 487 540 556 627 661 690 701 727 729 769 811 879 881 887 902 928 940 1066 1072 1128 1131 1234 1346 1497 
#module 66 size: 29 bs: 0.00280341
59 141 153 165 170 232 327 590 713 776 797 811 888 935 959 1009 1047 1063 1066 1111 1149 1177 1184 1285 1295 1383 1446 1451 1457 
#module 67 size: 32 bs: 0.000515736
49 61 77 112 122 198 251 351 486 525 581 599 610 649 672 847 950 960 968 986 1003 1004 1075 1127 1139 1157 1171 1175 1242 1280 1438 1446 
#module 68 size: 15 bs: 6.40454e-06
30 76 106 183 195 216 218 219 224 312 553 729 836 903 1081 
#module 69 size: 30 bs: 1.73108e-06
20 93 98 123 221 277 656 702 764 775 825 833 907 931 955 1067 1081 1121 1123 1138 1170 1208 1251 1260 1268 1319 1415 1419 1436 1483 
#module 70 size: 23 bs: 0.00310263
162 282 310 334 406 512 596 681 849 858 914 954 1027 1080 1083 1173 1197 1238 1291 1329 1429 1439 1440 
#module 71 size: 36 bs: 9.53209e-05
128 344 377 407 488 507 560 576 599 610 705 706 723 740 763 771 773 836 889 934 961 1001 1003 1088 1122 1131 1163 1172 1204 1245 1362 1371 1386 1429 1438 1475 
