#module 0 size: 15 bs: 0.00331521
12 44 65 107 115 129 139 174 176 283 355 367 491 505 691 
#module 1 size: 10 bs: 2.27909e-06
6 7 50 91 130 147 162 172 469 620 
#module 2 size: 17 bs: 7.3405e-05
42 212 234 290 291 293 360 369 388 402 427 439 493 534 594 595 672 
#module 3 size: 22 bs: 0.00142145
73 100 131 136 191 228 243 264 280 297 309 313 423 440 481 494 500 501 555 576 601 604 
#module 4 size: 24 bs: 0.00387041
81 112 126 142 145 183 220 269 285 311 351 359 383 408 419 481 512 513 634 647 651 661 676 694 
#module 5 size: 25 bs: 0.000155786
13 98 111 132 273 301 357 374 377 380 411 415 460 465 484 535 544 553 559 570 584 596 626 648 673 
#module 6 size: 35 bs: 0.00106137
41 80 101 102 140 143 144 171 195 196 218 239 246 258 279 307 310 325 335 339 342 366 412 439 467 524 537 543 548 558 567 582 611 638 664 
#module 7 size: 34 bs: 0.000742046
27 55 64 123 124 152 157 221 225 226 352 358 381 411 426 463 489 506 510 520 555 571 583 585 600 603 617 624 635 641 654 667 681 683 
#module 8 size: 26 bs: 0.000180109
127 187 193 203 208 237 240 249 254 256 275 343 404 429 451 461 465 479 482 487 503 506 609 635 648 675 
#module 9 size: 19 bs: 0.000109162
36 57 126 145 170 207 230 232 248 264 317 364 410 421 503 543 574 577 625 
#module 10 size: 29 bs: 0.00252722
18 35 160 224 233 247 254 286 287 289 338 352 363 374 390 392 396 525 527 529 534 541 574 587 595 607 652 660 687 
#module 11 size: 30 bs: 0.000501087
43 45 79 112 124 151 157 169 175 217 260 277 278 314 407 420 423 428 444 446 473 475 532 548 555 593 613 626 683 700 
#module 12 size: 30 bs: 0.00446396
17 38 71 93 105 136 138 159 170 201 205 329 335 340 422 427 438 454 495 523 532 561 579 598 649 657 672 674 679 692 
#module 13 size: 33 bs: 0.000400062
20 47 149 163 164 166 167 263 274 292 328 340 350 374 388 423 424 434 439 449 470 475 504 518 553 560 563 575 638 641 642 649 690 
#module 14 size: 18 bs: 0.000176275
97 106 134 161 189 319 320 324 341 347 379 404 409 440 484 530 576 625 
#module 15 size: 23 bs: 0.00240117
5 26 72 75 210 269 357 460 468 485 493 530 533 536 552 570 577 579 608 610 630 662 689 
#module 16 size: 19 bs: 1.76914e-05
62 113 190 311 345 396 399 470 485 492 531 542 556 597 622 633 658 666 669 
#module 17 size: 29 bs: 0.00106867
22 79 85 125 177 202 261 262 283 323 325 346 358 366 404 409 473 481 504 508 539 570 574 580 601 626 665 676 688 
#module 18 size: 12 bs: 4.67104e-05
87 118 219 302 333 384 505 509 540 554 567 695 
#module 19 size: 23 bs: 0.000608675
19 25 51 83 86 153 228 298 411 414 448 466 473 522 569 588 589 606 610 634 637 661 674 
#module 20 size: 25 bs: 0.00111046
15 120 146 175 182 192 303 316 353 361 377 390 396 413 428 445 455 478 491 528 529 566 610 627 632 
#module 21 size: 15 bs: 0.00488065
29 41 76 104 111 116 159 204 342 400 407 412 431 556 568 
#module 22 size: 25 bs: 0.00309257
14 94 128 135 155 196 253 261 336 390 409 431 475 490 498 499 500 583 586 599 635 666 682 686 700 
#module 23 size: 36 bs: 0.000763665
23 46 60 93 105 117 119 154 158 161 197 204 208 244 268 277 283 299 335 341 354 413 422 430 441 442 443 462 466 515 550 623 624 638 643 680 
#module 24 size: 16 bs: 0.00257705
96 100 142 196 203 233 266 315 344 395 436 477 542 560 568 595 
#module 25 size: 22 bs: 0.00425555
34 90 95 137 189 221 239 242 251 296 299 336 357 377 388 444 476 557 601 648 674 684 
#module 26 size: 33 bs: 0.000488828
53 59 70 89 150 159 186 223 231 238 258 264 287 299 304 310 376 398 416 424 434 457 486 516 517 527 530 545 547 562 589 618 653 
#module 27 size: 28 bs: 0.000402277
2 28 48 58 63 77 144 209 228 266 288 343 368 372 397 406 425 471 486 602 625 628 644 650 654 691 697 700 
#module 28 size: 15 bs: 0.000345971
32 88 178 239 246 270 288 393 410 440 488 538 560 613 621 
#module 29 size: 24 bs: 0.00358597
37 168 266 321 331 332 385 394 417 435 451 472 482 483 487 489 511 534 583 613 623 641 663 699 
#module 30 size: 31 bs: 0.00387255
8 16 61 68 78 101 112 148 173 221 243 250 271 306 312 356 365 387 450 456 509 564 605 614 623 629 646 656 666 677 678 
#module 31 size: 24 bs: 0.000256335
56 100 123 152 199 203 206 211 214 218 235 313 341 381 391 400 427 450 539 546 549 606 687 688 
#module 32 size: 19 bs: 3.67891e-05
33 92 114 120 178 200 255 257 281 294 326 348 452 454 509 525 539 622 685 
#module 33 size: 31 bs: 0.0029236
3 119 165 169 171 185 198 199 213 245 310 362 414 437 447 450 464 487 512 528 535 556 589 609 633 646 655 657 671 689 698 
#module 34 size: 17 bs: 0.000503081
1 84 122 186 208 259 322 434 453 484 500 532 563 594 606 657 684 
#module 35 size: 13 bs: 2.77565e-06
24 30 49 66 74 103 108 272 288 348 398 548 649 
#module 36 size: 33 bs: 0.00178642
39 67 69 136 140 184 231 246 258 267 272 284 308 334 355 368 386 418 428 470 477 483 527 563 565 573 581 584 609 616 640 672 695 
#module 37 size: 34 bs: 0.000120062
52 93 111 138 179 180 181 295 305 318 323 332 337 339 349 389 401 406 447 455 480 485 519 551 568 590 615 619 636 645 668 676 679 693 
#module 38 size: 24 bs: 0.00311257
83 110 141 156 183 188 189 236 265 367 375 459 489 493 526 535 577 620 639 644 665 686 687 689 
#module 39 size: 20 bs: 0.000123686
81 133 182 194 229 241 320 378 410 431 432 461 474 578 592 631 664 667 683 691 
#module 40 size: 20 bs: 0.000240884
121 126 205 215 290 304 346 405 406 458 507 511 525 573 630 646 659 664 684 685 
#module 41 size: 27 bs: 0.00174036
31 82 109 227 252 276 330 336 382 403 415 469 502 503 512 514 531 542 584 591 612 654 661 665 670 679 688 
#module 42 size: 28 bs: 0.000104872
21 51 101 211 216 222 254 282 300 327 348 370 371 415 433 455 469 496 497 521 531 553 572 622 630 631 644 696 
