#module 0 size: 34 bs: 0.0018546
6 82 125 126 133 134 139 161 172 221 230 249 263 264 332 333 357 400 450 454 474 521 564 566 605 615 629 636 638 644 648 664 688 700 
#module 1 size: 25 bs: 0.000485171
73 90 179 234 298 302 306 333 342 392 425 469 485 488 490 509 530 538 540 544 552 653 654 671 683 
#module 2 size: 28 bs: 1.49397e-05
2 55 85 131 147 157 170 171 188 203 211 250 275 282 315 347 353 383 404 453 464 498 529 629 631 642 669 681 
#module 3 size: 27 bs: 1.49397e-05
5 86 88 103 182 220 222 238 284 336 358 414 422 467 477 481 493 513 531 580 584 593 604 621 630 637 655 
#module 4 size: 15 bs: 4.01744e-06
23 33 54 62 174 267 286 296 307 343 379 491 535 581 694 
#module 5 size: 25 bs: 0.00222892
8 17 27 32 127 144 183 208 210 223 227 270 293 310 325 387 415 418 420 421 439 463 525 677 696 
#module 6 size: 21 bs: 7.21682e-05
3 42 72 77 99 148 165 166 225 318 369 497 523 547 562 613 616 620 623 656 686 
#module 7 size: 32 bs: 0.00142577
58 83 92 112 115 116 117 168 176 236 251 258 273 279 333 341 375 380 409 417 431 450 499 502 533 575 629 632 651 657 662 690 
#module 8 size: 31 bs: 0.000347177
21 24 46 50 80 104 128 205 218 257 276 300 320 323 329 335 363 365 371 398 401 413 455 471 524 527 542 569 608 645 673 
#module 9 size: 26 bs: 0.00232291
7 26 57 107 136 153 158 194 260 319 338 345 366 385 386 390 393 448 543 546 554 610 612 628 635 676 
#module 10 size: 34 bs: 0.00067268
12 14 20 68 121 138 150 164 174 178 195 248 291 294 295 348 352 367 405 452 456 473 476 484 492 514 550 574 577 598 634 646 665 698 
#module 11 size: 24 bs: 0.000345621
81 94 95 154 186 192 240 243 246 272 304 374 443 478 482 489 496 546 596 614 639 660 672 692 
#module 12 size: 31 bs: 0.000454768
31 38 78 91 96 113 122 124 162 163 189 241 247 308 337 355 372 373 412 432 446 506 571 572 588 601 609 625 633 663 693 
#module 13 size: 31 bs: 0.000579312
35 37 60 76 132 181 219 226 232 281 311 330 351 360 397 475 494 505 512 516 549 563 568 583 602 617 624 670 684 691 697 
#module 14 size: 24 bs: 1.08524e-05
10 18 52 70 74 100 120 140 193 212 213 237 259 278 297 299 317 334 396 436 462 501 517 597 
#module 15 size: 15 bs: 4.78082e-07
106 167 209 249 266 319 407 449 461 486 504 536 556 592 658 
#module 16 size: 22 bs: 0.000124586
19 69 108 123 135 176 182 198 239 245 327 362 364 378 394 399 405 406 438 457 537 647 
#module 17 size: 27 bs: 0.000292511
43 75 79 152 202 252 254 255 271 277 290 346 350 368 370 381 388 389 423 444 445 460 479 518 565 606 685 
#module 18 size: 23 bs: 0.0011558
1 28 47 101 142 149 196 197 249 287 321 340 434 468 522 532 567 573 585 635 643 682 687 
#module 19 size: 29 bs: 0.000150906
51 87 114 153 173 214 216 242 244 253 274 312 314 322 359 382 419 428 434 437 507 530 544 570 587 591 600 611 659 
#module 20 size: 34 bs: 0.00499101
4 16 34 57 71 93 119 184 224 235 262 305 324 354 391 402 433 437 466 470 528 537 541 545 548 559 586 661 662 666 669 678 680 689 
#module 21 size: 34 bs: 0.00320355
13 29 48 53 61 66 67 98 105 155 156 215 228 285 301 316 359 376 410 416 425 440 447 451 466 500 530 582 594 627 650 667 669 694 
#module 22 size: 34 bs: 0.000757385
15 97 109 143 159 175 206 217 231 294 309 331 349 395 427 441 459 466 472 487 503 508 534 551 561 578 589 595 662 674 679 689 695 699 
#module 23 size: 26 bs: 0.000149898
59 89 145 177 254 283 289 292 294 303 313 339 344 368 377 424 427 430 435 465 495 515 539 553 560 607 
#module 24 size: 21 bs: 8.44931e-05
36 111 169 190 260 261 265 280 411 429 458 483 544 557 576 619 622 626 641 659 698 
#module 25 size: 21 bs: 0.00277423
11 40 49 56 102 110 137 141 160 200 229 268 288 298 328 408 526 589 596 652 668 
#module 26 size: 16 bs: 7.2991e-05
22 64 187 256 326 356 403 419 448 483 486 510 511 520 555 618 
#module 27 size: 27 bs: 0.000103596
39 118 146 151 180 185 191 199 207 233 269 361 384 426 442 480 519 537 558 579 590 599 603 635 640 649 675 
