#module 0 size: 13 bs: 0.000358333
4 9 14 42 45 53 67 90 301 501 508 522 605 
#module 1 size: 34 bs: 0.00245233
29 110 112 116 119 121 125 145 193 217 292 323 344 363 386 430 432 452 475 506 508 513 530 531 545 548 564 572 585 621 646 656 663 674 
#module 2 size: 26 bs: 0.000428198
158 206 212 213 226 255 303 308 317 318 336 368 405 434 486 529 555 568 607 608 616 636 641 644 647 649 
#module 3 size: 20 bs: 0.00103125
11 41 50 76 133 150 159 217 219 220 235 291 294 307 313 324 371 391 554 668 
#module 4 size: 26 bs: 0.00024676
26 31 35 80 85 177 211 268 274 280 295 301 302 366 443 467 474 477 478 523 576 620 643 652 660 687 
#module 5 size: 25 bs: 0.00278278
44 119 120 123 160 174 178 248 259 289 311 390 394 410 412 435 463 498 509 549 553 615 645 659 698 
#module 6 size: 12 bs: 0.00493691
96 106 117 173 199 216 252 372 379 380 449 565 
#module 7 size: 38 bs: 0.00241277
28 66 88 108 153 173 205 225 227 238 247 259 264 269 285 299 358 360 379 383 386 387 396 399 424 438 444 465 495 511 514 565 566 604 617 669 688 693 
#module 8 size: 17 bs: 6.2403e-05
24 54 87 257 262 273 461 487 533 536 537 558 584 638 678 686 696 
#module 9 size: 26 bs: 0.000372365
3 43 48 63 124 173 175 190 198 221 227 259 272 297 309 315 346 384 387 392 397 458 468 483 496 606 
#module 10 size: 33 bs: 4.08302e-05
16 23 36 101 107 179 187 208 240 249 267 271 293 302 336 367 385 392 400 404 416 446 453 491 492 494 531 542 580 601 633 650 666 
#module 11 size: 34 bs: 0.000214808
131 156 163 180 191 200 236 286 312 347 351 362 402 440 442 472 493 499 502 511 517 524 531 565 579 596 597 601 630 632 645 661 662 675 
#module 12 size: 30 bs: 0.00439866
25 83 100 102 118 201 227 242 265 279 320 321 328 342 357 409 507 514 518 554 605 609 624 632 645 667 675 679 691 692 
#module 13 size: 34 bs: 0.000473037
6 12 78 117 140 152 162 203 250 270 289 325 327 369 375 376 418 441 447 455 470 513 538 547 564 596 601 617 618 626 628 665 668 682 
#module 14 size: 31 bs: 0.000238544
17 18 94 136 155 174 251 290 374 385 393 425 426 430 450 456 490 497 499 543 544 556 581 596 599 616 637 648 653 661 668 
#module 15 size: 19 bs: 0.0022682
37 56 60 79 154 157 182 229 232 290 355 373 403 415 427 432 437 471 507 
#module 16 size: 29 bs: 0.00010255
1 20 27 28 34 38 86 114 145 146 149 261 290 329 381 382 388 420 421 459 503 510 526 567 613 614 616 625 699 
#module 17 size: 15 bs: 0.00187124
8 15 46 64 71 73 77 81 137 160 305 346 354 602 679 
#module 18 size: 21 bs: 0.000445049
103 115 136 233 266 385 387 401 501 507 514 519 535 550 552 569 602 622 632 642 673 
#module 19 size: 39 bs: 0.0013792
2 40 75 135 165 169 189 196 215 223 233 274 278 282 283 288 293 327 348 350 354 361 377 384 475 485 488 508 535 537 557 578 589 590 592 612 638 640 679 
#module 20 size: 30 bs: 0.00193797
13 55 57 61 62 91 92 94 124 126 144 228 236 243 268 276 287 293 310 319 354 357 383 433 513 587 605 651 685 697 
#module 21 size: 21 bs: 1.17755e-05
19 72 147 160 172 186 221 230 263 281 330 332 357 384 395 428 489 524 564 591 649 
#module 22 size: 17 bs: 0.000119831
7 10 109 122 127 130 134 168 181 210 231 241 314 321 442 644 699 
#module 23 size: 23 bs: 0.00313617
138 139 272 310 331 336 337 349 356 359 370 406 421 423 430 454 473 476 558 563 635 639 657 
#module 24 size: 35 bs: 0.00255322
178 190 204 207 222 253 255 258 272 289 304 314 321 338 339 345 408 432 460 462 464 466 491 504 510 512 529 546 562 574 593 595 634 664 684 
#module 25 size: 38 bs: 0.000515925
21 58 65 84 98 148 170 185 195 204 221 224 229 245 250 300 316 322 341 378 383 411 429 480 491 499 535 539 543 554 578 603 610 623 644 675 676 680 
#module 26 size: 36 bs: 0.00210189
22 34 89 95 98 111 123 129 161 167 234 235 268 274 277 284 310 316 325 353 378 417 419 442 481 537 543 558 561 575 578 583 638 670 671 695 
#module 27 size: 26 bs: 0.00142072
5 47 52 74 124 170 172 192 197 244 246 286 295 302 363 457 520 534 541 577 627 629 683 689 694 700 
#module 28 size: 33 bs: 0.00331016
30 32 49 61 70 80 104 113 167 174 176 212 254 298 304 326 333 378 389 469 479 497 509 516 517 522 528 529 559 570 619 631 657 
#module 29 size: 36 bs: 0.00249824
51 69 98 111 142 164 212 214 235 275 296 301 346 350 352 386 410 414 423 515 517 521 524 532 540 551 557 582 586 588 594 598 627 677 681 690 
#module 30 size: 19 bs: 0.00397955
39 68 143 166 171 183 188 202 209 217 306 335 340 353 407 439 458 465 639 
#module 31 size: 34 bs: 0.000163979
33 59 97 99 105 128 132 141 239 256 325 364 365 435 445 448 451 475 482 505 511 522 525 560 573 602 611 627 654 655 657 661 698 699 
#module 32 size: 33 bs: 0.000211388
82 93 151 184 194 218 224 241 250 260 327 334 343 363 398 413 421 422 431 435 436 465 484 497 500 501 510 527 571 600 649 658 672 
