#module 0 size: 23 bs: 6.04981e-06
52 108 127 132 134 166 182 188 277 314 371 374 395 436 444 466 474 478 520 549 557 591 635 
#module 1 size: 15 bs: 5.8171e-06
72 76 91 380 381 409 420 432 438 493 506 541 562 565 600 
#module 2 size: 10 bs: 0.00127077
38 136 212 216 222 266 289 460 498 556 
#module 3 size: 16 bs: 0.000251783
68 86 107 154 161 170 178 184 186 220 284 350 369 535 641 655 
#module 4 size: 20 bs: 0.00371315
24 26 50 94 106 156 242 254 280 282 310 366 405 441 476 496 527 555 587 609 
#module 5 size: 18 bs: 0.000728766
19 43 87 93 116 214 219 271 287 302 364 379 389 525 621 622 633 648 
#module 6 size: 20 bs: 0.00163486
34 129 151 233 235 262 354 359 361 363 398 423 431 433 463 479 519 560 569 579 
#module 7 size: 10 bs: 2.22315e-05
210 322 342 352 456 482 548 592 605 650 
#module 8 size: 11 bs: 0.00203963
21 47 58 138 232 529 592 594 603 636 645 
#module 9 size: 27 bs: 0.00156117
7 20 63 75 95 135 172 179 190 221 273 347 360 393 410 454 488 489 507 539 547 558 568 578 596 597 623 
#module 10 size: 18 bs: 1.15194e-05
36 81 83 173 187 200 245 286 295 296 448 471 480 538 617 671 683 687 
#module 11 size: 30 bs: 0.00132852
30 41 114 189 226 229 247 256 300 312 331 390 397 450 452 481 499 517 523 580 615 640 642 643 666 677 680 688 696 699 
#module 12 size: 21 bs: 3.68155e-05
71 73 118 144 146 164 237 303 341 428 435 462 467 532 619 624 632 634 665 686 695 
#module 13 size: 17 bs: 1.60261e-05
53 133 147 176 211 228 259 362 376 387 473 564 584 599 613 631 663 
#module 14 size: 17 bs: 3.44508e-05
80 97 139 141 198 205 308 345 396 404 437 550 606 607 620 656 657 
#module 15 size: 23 bs: 0.000581193
13 25 32 82 155 183 274 279 306 345 365 368 370 382 401 416 419 453 486 536 577 589 595 
#module 16 size: 14 bs: 1.04817e-06
78 143 181 240 268 283 439 442 495 530 534 601 618 638 
#module 17 size: 14 bs: 0.00023704
99 197 250 307 313 315 329 349 415 490 494 592 689 694 
#module 18 size: 23 bs: 0.00164076
42 115 123 192 195 223 263 272 323 333 340 343 383 384 468 512 590 602 610 639 660 670 698 
#module 19 size: 27 bs: 0.000636319
29 160 201 224 257 258 275 293 400 402 406 412 418 421 445 477 516 559 571 582 607 650 659 672 682 684 700 
#module 20 size: 17 bs: 1.14618e-05
70 148 150 158 185 213 218 236 244 292 399 491 501 540 553 581 662 
#module 21 size: 11 bs: 7.41334e-11
51 100 113 130 145 175 267 276 330 457 500 
#module 22 size: 12 bs: 6.59932e-11
89 131 174 206 227 264 324 492 533 588 593 673 
#module 23 size: 11 bs: 0.000641757
69 112 157 299 325 357 388 458 576 650 675 
#module 24 size: 13 bs: 0.00124771
15 16 61 191 230 238 291 301 449 497 537 597 679 
#module 25 size: 26 bs: 2.25111e-05
8 62 77 98 169 207 215 217 225 255 288 309 358 446 447 461 521 522 559 567 574 576 598 612 669 698 
#module 26 size: 19 bs: 0.000142074
28 85 193 194 248 252 311 326 338 356 372 403 411 464 485 508 510 559 583 
#module 27 size: 17 bs: 0.00294045
40 60 104 153 196 332 339 373 424 427 459 524 546 582 644 645 675 
#module 28 size: 20 bs: 0.000420753
35 64 90 103 128 135 171 208 272 321 385 408 455 528 545 603 653 658 664 685 
#module 29 size: 15 bs: 0.00316044
119 124 202 344 348 355 378 394 470 509 513 543 620 652 690 
#module 30 size: 18 bs: 0.000323814
44 74 96 111 149 162 204 209 234 253 261 285 304 386 486 570 616 691 
#module 31 size: 17 bs: 0.00140901
55 168 203 281 317 328 411 502 531 566 585 614 629 647 668 681 690 
#module 32 size: 16 bs: 0.000515059
37 46 180 246 260 265 298 422 426 505 521 552 654 657 674 693 
#module 33 size: 22 bs: 0.00113263
4 101 251 318 335 337 417 429 434 443 451 465 563 572 586 626 637 658 661 692 697 698 
#module 34 size: 21 bs: 0.00317466
1 5 18 45 65 66 67 92 159 320 346 351 377 400 440 518 544 561 625 651 676 
#module 35 size: 23 bs: 0.000912839
12 88 121 152 167 199 231 269 375 392 483 503 542 551 566 572 573 575 604 630 646 667 689 
#module 36 size: 17 bs: 0.00108984
17 22 59 117 278 327 336 425 469 484 487 504 511 531 608 611 627 
