#module 0 size: 23 bs: 0.000113788
1 23 54 100 119 134 194 196 204 247 248 312 330 332 338 426 461 489 532 573 576 657 667 
#module 1 size: 24 bs: 3.35431e-05
9 52 77 105 137 164 186 187 246 261 286 292 297 310 346 407 434 441 577 648 654 672 673 676 
#module 2 size: 17 bs: 8.61325e-08
34 118 180 300 301 319 342 429 473 504 507 523 544 600 619 675 696 
#module 3 size: 16 bs: 1.98436e-05
17 42 64 156 182 243 251 309 379 394 432 442 488 514 663 666 
#module 4 size: 28 bs: 0.000314935
14 15 31 59 110 147 181 186 226 239 269 283 288 292 363 383 397 411 462 516 518 534 547 560 587 622 678 691 
#module 5 size: 18 bs: 6.10338e-07
56 215 230 268 274 288 315 357 361 366 412 493 539 593 623 644 655 659 
#module 6 size: 13 bs: 6.48591e-08
99 212 237 259 336 389 417 564 574 575 636 660 665 
#module 7 size: 15 bs: 0.000183105
3 19 50 65 144 162 169 201 257 372 375 454 497 559 562 
#module 8 size: 16 bs: 0.000149754
6 167 177 211 218 260 291 325 331 355 374 422 529 647 650 662 
#module 9 size: 17 bs: 0.000300394
26 73 207 234 265 290 308 410 416 456 467 485 496 590 631 677 695 
#module 10 size: 16 bs: 0.00257834
55 120 126 131 345 354 356 386 391 451 487 502 541 617 639 698 
#module 11 size: 9 bs: 0.000694394
148 163 200 302 306 314 322 460 499 
#module 12 size: 21 bs: 4.87971e-05
44 48 57 75 86 122 132 216 219 227 264 296 299 373 401 418 465 556 607 635 685 
#module 13 size: 11 bs: 6.77869e-11
92 240 287 316 402 475 568 579 604 630 683 
#module 14 size: 10 bs: 5.09896e-10
71 253 270 351 368 447 472 509 531 693 
#module 15 size: 7 bs: 5.2311e-06
53 91 231 249 435 471 688 
#module 16 size: 10 bs: 9.8641e-09
11 20 38 191 304 382 503 510 525 595 
#module 17 size: 10 bs: 5.93236e-08
7 13 252 335 486 515 615 649 661 664 
#module 18 size: 10 bs: 2.9567e-08
8 130 154 307 323 367 390 446 605 651 
#module 19 size: 20 bs: 4.80758e-07
72 117 149 195 222 272 277 278 305 317 333 425 468 469 583 584 586 641 684 700 
#module 20 size: 13 bs: 0.000128012
5 142 157 203 208 254 327 400 444 491 588 625 689 
#module 21 size: 13 bs: 0.00239656
18 49 113 140 344 470 534 567 578 626 645 692 694 
#module 22 size: 20 bs: 5.73042e-05
153 236 271 282 292 360 414 424 433 439 492 501 508 569 599 614 618 642 658 681 
#module 23 size: 16 bs: 3.02354e-05
67 85 133 145 179 183 205 223 337 448 490 506 522 530 538 699 
#module 24 size: 17 bs: 3.46287e-05
27 89 184 225 262 294 385 387 430 479 480 553 596 610 612 633 679 
#module 25 size: 32 bs: 0.000139631
21 29 33 90 121 168 174 273 312 370 393 395 408 415 433 449 481 482 484 498 545 547 551 554 561 566 594 621 629 632 656 671 
#module 26 size: 15 bs: 1.82784e-05
40 123 124 192 202 310 384 388 455 527 552 639 654 676 691 
#module 27 size: 12 bs: 3.56208e-07
82 109 228 281 311 398 431 440 536 572 643 653 
#module 28 size: 14 bs: 0.000226289
70 103 127 129 160 213 275 289 295 313 376 437 443 640 
#module 29 size: 25 bs: 0.00309058
4 94 147 158 170 176 202 209 214 232 245 246 258 339 343 364 378 387 439 474 495 513 578 592 597 
#module 30 size: 9 bs: 0.000965767
10 106 138 159 369 445 508 580 598 
#module 31 size: 11 bs: 5.15523e-07
68 114 172 188 198 210 371 413 563 613 674 
#module 32 size: 22 bs: 4.70149e-05
16 23 35 39 66 81 96 97 128 178 197 303 347 365 377 399 626 632 652 678 686 692 
#module 33 size: 21 bs: 0.000166662
12 43 51 107 152 165 255 293 298 403 459 462 527 542 546 558 606 629 668 673 691 
#module 34 size: 9 bs: 9.06547e-07
62 190 241 450 549 555 581 601 634 
#module 35 size: 17 bs: 0.000111636
79 242 245 250 318 329 397 458 459 520 524 535 550 560 624 637 687 
#module 36 size: 9 bs: 1.09612e-08
108 151 199 328 341 350 378 421 565 
#module 37 size: 20 bs: 0.00256027
2 24 146 185 193 229 340 353 405 427 458 543 571 589 591 608 622 625 669 680 
#module 38 size: 28 bs: 4.04113e-05
45 116 136 217 256 267 279 284 359 419 423 445 453 462 464 476 484 508 521 554 558 566 589 608 609 626 656 658 
#module 39 size: 60 bs: 0.00257834
36 63 98 125 134 143 155 161 171 178 189 197 209 263 269 276 326 334 346 348 349 352 358 395 404 405 409 420 428 463 466 477 483 494 500 512 517 519 526 540 548 557 558 570 571 582 585 602 621 628 629 646 656 658 663 668 670 673 691 692 
#module 40 size: 17 bs: 4.80235e-05
37 58 61 83 186 244 285 321 362 411 436 478 492 511 517 537 592 
#module 41 size: 19 bs: 2.63801e-05
28 76 112 206 221 396 403 528 533 548 561 585 603 611 616 618 638 682 686 
