#module 0 size: 22 bs: 0.000115159
2 3 133 142 196 202 224 233 274 291 388 403 405 423 442 445 457 487 498 518 545 680 
#module 1 size: 28 bs: 0.000620603
4 22 27 59 97 158 175 180 181 259 272 316 364 391 396 418 424 427 428 439 455 474 484 500 552 580 598 675 
#module 2 size: 20 bs: 7.61863e-05
18 88 103 156 211 226 257 272 278 286 383 412 433 474 481 507 546 547 673 695 
#module 3 size: 21 bs: 0.000169855
49 50 66 78 85 104 113 168 223 236 318 366 413 439 491 515 595 624 646 649 686 
#module 4 size: 30 bs: 0.000614083
10 35 121 145 154 204 255 267 303 311 317 331 333 336 372 387 394 427 447 475 527 535 573 577 615 630 642 669 678 697 
#module 5 size: 31 bs: 0.00116903
1 29 51 95 96 220 246 265 282 287 294 321 330 335 339 340 351 367 448 501 522 564 586 588 590 602 617 636 661 684 691 
#module 6 size: 13 bs: 4.52649e-06
34 48 63 229 260 279 301 354 436 471 492 628 653 
#module 7 size: 29 bs: 0.0010705
77 83 93 137 138 178 185 210 215 256 284 318 341 361 384 410 418 419 424 463 525 565 568 585 621 634 655 679 700 
#module 8 size: 27 bs: 7.68298e-05
6 37 58 98 101 174 187 201 222 271 290 334 379 408 435 490 499 550 567 573 575 576 578 610 666 684 685 
#module 9 size: 28 bs: 0.00224134
14 71 129 166 195 227 239 245 300 341 377 408 430 459 485 504 510 517 544 561 581 589 610 622 629 652 682 690 
#module 10 size: 15 bs: 0.00179098
9 31 74 151 214 225 281 298 312 323 443 524 567 596 623 
#module 11 size: 20 bs: 0.000463204
70 75 90 171 188 202 253 282 284 407 431 437 458 506 519 570 579 650 676 697 
#module 12 size: 27 bs: 0.0010407
26 62 126 170 183 207 217 281 295 315 319 353 368 382 393 465 479 483 497 513 527 534 551 584 619 631 669 
#module 13 size: 26 bs: 0.000808561
30 32 45 65 84 91 106 125 148 199 232 262 338 371 380 426 429 433 494 516 524 562 608 633 639 680 
#module 14 size: 32 bs: 0.000564947
23 39 64 100 134 144 146 147 194 230 231 247 252 314 357 373 413 415 432 437 467 488 489 516 549 587 605 647 654 659 672 695 
#module 15 size: 63 bs: 0.00451359
24 25 29 47 52 67 72 76 80 93 108 119 120 124 131 149 161 162 173 179 190 205 206 218 235 242 325 350 369 378 385 386 395 399 401 411 422 426 472 482 495 502 506 509 528 553 555 557 558 569 572 574 606 618 641 643 645 651 667 668 687 690 692 
#module 16 size: 13 bs: 1.82532e-05
16 42 55 167 248 263 349 359 400 506 625 670 674 
#module 17 size: 27 bs: 0.000360265
7 28 38 112 116 155 159 228 245 293 304 306 324 348 365 398 424 450 456 486 508 538 601 614 621 626 695 
#module 18 size: 28 bs: 0.00275365
76 81 115 118 164 182 200 253 261 271 320 326 330 361 363 440 441 499 531 591 594 600 602 626 644 657 663 683 
#module 19 size: 29 bs: 0.000694022
17 60 82 186 213 234 238 289 292 311 315 332 427 434 469 473 477 480 533 536 541 582 628 638 656 664 669 671 696 
#module 20 size: 12 bs: 0.00128861
79 141 191 240 283 327 362 421 425 438 627 691 
#module 21 size: 14 bs: 1.20177e-05
56 176 216 266 285 309 404 505 530 540 543 573 616 627 
#module 22 size: 27 bs: 0.00328568
43 73 87 99 172 203 217 243 275 305 343 352 393 402 409 439 460 468 470 478 493 559 571 609 616 662 676 
#module 23 size: 31 bs: 0.00135061
15 41 143 163 193 198 208 221 299 328 329 359 381 406 414 417 454 465 476 548 566 589 613 621 625 640 643 665 694 697 699 
#module 24 size: 25 bs: 0.000208454
33 61 110 114 123 160 241 308 310 376 417 422 436 437 444 451 466 511 532 576 592 604 607 658 688 
#module 25 size: 31 bs: 0.00270478
69 99 136 152 165 171 189 209 237 249 250 270 281 313 345 358 365 397 449 453 464 503 512 514 539 556 611 635 637 642 653 
#module 26 size: 25 bs: 0.00353527
13 19 20 46 53 68 92 94 102 140 210 234 273 276 295 296 297 330 356 383 461 468 563 593 690 
#module 27 size: 16 bs: 0.00026674
117 128 139 268 307 420 452 496 554 560 610 622 648 653 658 660 
#module 28 size: 15 bs: 2.0167e-06
127 153 269 322 337 344 347 370 375 416 526 597 620 677 693 
#module 29 size: 32 bs: 0.00120313
8 12 20 36 54 57 107 109 130 132 135 184 244 251 280 315 342 355 359 360 389 392 516 520 542 554 583 599 603 612 681 689 
#module 30 size: 33 bs: 0.00251352
11 44 86 94 111 169 192 197 219 254 264 272 278 302 342 346 351 374 390 417 422 446 462 521 523 527 529 537 593 617 632 676 698 
