#module 0 size: 23 bs: 0.00225921
4 12 25 52 74 80 81 171 180 221 237 241 255 276 282 302 394 438 463 480 493 599 640 
#module 1 size: 24 bs: 0.000471421
5 24 54 55 82 112 116 118 142 221 234 243 314 328 378 394 424 542 559 631 649 667 692 699 
#module 2 size: 29 bs: 0.000656836
23 93 122 160 213 230 239 263 273 312 316 355 386 387 437 447 488 499 501 526 544 562 576 585 641 657 680 684 685 
#module 3 size: 28 bs: 0.00157813
14 20 30 45 75 83 118 135 146 158 218 231 296 333 342 364 380 397 479 521 529 553 563 566 568 585 660 679 
#module 4 size: 30 bs: 0.000446613
44 91 142 147 154 163 174 233 254 264 289 301 310 311 357 370 383 401 408 414 435 462 482 492 572 582 593 619 621 622 
#module 5 size: 23 bs: 0.00129658
96 175 177 179 184 240 246 309 317 369 424 427 428 453 463 493 574 598 600 632 654 659 681 
#module 6 size: 14 bs: 0.00169104
71 138 153 156 268 337 351 446 449 473 590 620 658 660 
#module 7 size: 35 bs: 0.00474616
6 37 108 120 154 176 192 207 216 240 251 292 293 298 321 364 376 381 408 448 454 466 506 530 543 571 578 585 616 649 663 664 676 686 687 
#module 8 size: 19 bs: 3.12554e-05
34 100 107 123 144 165 194 211 222 234 267 283 341 445 498 558 594 629 651 
#module 9 size: 22 bs: 0.00272218
19 53 88 89 121 145 150 159 189 258 260 294 306 318 353 386 390 395 405 496 499 579 
#module 10 size: 20 bs: 3.51021e-05
10 33 39 90 155 158 172 206 225 335 346 391 397 402 412 511 592 671 672 680 
#module 11 size: 32 bs: 0.00265616
9 25 43 47 73 75 79 125 143 181 188 208 210 262 288 291 320 345 370 409 426 508 515 533 558 569 591 634 649 650 658 676 
#module 12 size: 34 bs: 0.000929008
13 16 30 59 87 116 118 149 168 188 193 296 326 336 365 366 379 407 408 434 440 454 476 483 491 493 514 524 534 538 549 570 643 648 
#module 13 size: 16 bs: 0.000998206
27 130 281 468 500 542 572 593 595 636 652 663 674 688 690 698 
#module 14 size: 18 bs: 0.0013065
84 113 151 164 187 197 199 217 294 305 325 327 420 535 542 545 547 626 
#module 15 size: 17 bs: 0.00390257
1 68 111 185 188 244 297 336 338 361 375 379 411 599 650 654 671 
#module 16 size: 15 bs: 0.0011702
2 21 38 54 60 78 85 110 275 305 306 513 546 581 636 
#module 17 size: 15 bs: 0.0010883
18 41 50 111 183 319 323 350 429 433 441 487 556 591 639 
#module 18 size: 19 bs: 6.29604e-05
15 73 81 162 173 196 232 250 275 307 318 331 398 404 486 496 504 535 651 
#module 19 size: 26 bs: 0.000388955
31 227 252 284 315 321 343 393 396 418 444 461 467 503 516 526 547 548 562 587 596 623 625 648 670 682 
#module 20 size: 35 bs: 0.00217948
6 36 46 55 69 97 98 104 105 137 139 158 166 190 214 221 228 235 244 312 359 398 425 436 445 509 536 553 574 583 603 622 642 646 695 
#module 21 size: 23 bs: 0.000437127
163 223 255 259 273 280 286 299 300 420 423 450 489 519 527 578 587 614 618 651 655 660 665 
#module 22 size: 32 bs: 0.000425608
65 116 131 141 152 178 241 263 274 285 288 292 381 397 400 452 456 459 475 477 483 495 497 518 525 528 554 562 594 597 626 676 
#module 23 size: 29 bs: 0.00205049
72 98 109 114 132 193 220 273 304 309 313 329 349 358 409 451 478 509 511 515 522 523 561 586 592 594 608 637 663 
#module 24 size: 22 bs: 0.00130087
105 218 238 272 296 340 364 390 395 402 406 411 513 533 540 584 591 601 602 626 688 694 
#module 25 size: 34 bs: 0.00294369
8 92 94 95 136 202 203 212 251 294 301 306 308 311 328 339 382 399 410 411 415 425 429 483 487 510 555 567 605 630 668 670 671 675 
#module 26 size: 15 bs: 0.000275841
56 70 83 159 195 242 255 278 399 603 605 629 639 681 696 
#module 27 size: 30 bs: 0.000168362
40 42 57 119 124 235 256 271 330 372 377 379 385 403 405 424 428 444 457 459 471 498 503 505 579 606 616 630 635 648 
#module 28 size: 28 bs: 0.002659
18 62 167 177 184 193 198 200 209 229 236 245 248 345 352 390 458 460 502 504 516 550 613 619 678 680 688 695 
#module 29 size: 24 bs: 0.00137045
106 117 219 287 313 329 363 464 469 473 474 490 526 532 533 551 580 598 609 615 638 655 673 683 
#module 30 size: 23 bs: 0.0009994
61 76 97 205 237 266 313 324 348 387 388 396 419 426 441 465 492 536 552 554 558 684 689 
#module 31 size: 34 bs: 0.000420506
28 44 48 58 86 146 191 200 257 272 291 293 362 386 388 403 431 432 471 512 522 536 547 565 586 587 609 629 633 639 645 656 662 700 
#module 32 size: 34 bs: 0.00272932
3 35 66 89 253 275 277 309 347 371 384 401 406 422 426 430 464 470 485 515 560 578 583 589 604 605 607 609 612 623 627 628 669 678 
#module 33 size: 32 bs: 4.76273e-05
72 102 119 127 128 157 161 234 249 259 265 303 304 356 416 418 421 442 473 481 537 556 583 596 611 619 647 650 666 670 683 689 
#module 34 size: 40 bs: 0.00120953
17 32 47 49 101 104 115 133 145 148 166 260 285 314 360 378 395 398 406 417 429 464 481 498 504 518 557 560 572 573 575 610 624 655 677 681 690 695 696 697 
#module 35 size: 28 bs: 3.48225e-05
11 103 131 140 165 170 182 224 270 279 290 301 361 368 403 409 439 443 454 516 535 541 577 622 630 637 653 672 
#module 36 size: 37 bs: 0.00359038
64 87 99 189 204 239 260 265 269 312 317 322 328 332 343 354 361 389 399 441 459 488 494 496 503 513 520 522 531 539 554 564 586 644 661 672 678 
#module 37 size: 25 bs: 0.0037743
77 129 131 134 174 226 250 259 261 293 311 374 381 463 472 492 507 517 546 560 588 646 683 691 693 
#module 38 size: 19 bs: 0.00170754
29 169 186 223 288 316 353 367 373 383 413 455 579 581 598 603 610 654 689 
#module 39 size: 29 bs: 0.00310642
22 51 63 104 120 140 201 215 226 247 250 285 295 334 344 352 377 392 418 471 484 545 553 556 599 617 623 646 696 
