#module 0 size: 40 bs: 6.16226e-05
1 50 298 309 338 375 381 434 438 467 470 489 690 721 765 883 899 977 1075 1098 1111 1150 1185 1228 1232 1300 1342 1364 1389 1412 1414 1441 1470 1487 1524 1553 1562 1563 1571 1576 
#module 1 size: 28 bs: 0.000169377
87 137 233 314 348 354 402 464 481 546 575 608 633 788 839 856 879 980 982 990 1027 1098 1104 1192 1318 1476 1500 1640 
#module 2 size: 29 bs: 5.22071e-06
156 234 277 280 291 598 677 696 768 776 895 968 1010 1056 1062 1101 1179 1279 1300 1337 1354 1363 1372 1422 1479 1547 1573 1680 1693 
#module 3 size: 31 bs: 0.000275098
102 193 203 249 397 440 479 636 644 669 685 700 738 749 822 851 863 913 1062 1065 1123 1172 1238 1322 1441 1541 1550 1574 1598 1604 1663 
#module 4 size: 31 bs: 1.55684e-07
245 355 485 564 591 605 822 871 896 929 974 1018 1045 1110 1126 1131 1198 1199 1220 1233 1345 1347 1394 1495 1529 1559 1571 1583 1634 1647 1652 
#module 5 size: 19 bs: 5.70855e-06
103 181 297 351 435 508 534 561 679 746 774 848 897 923 942 948 1014 1432 1460 
#module 6 size: 19 bs: 0.000306792
26 61 153 201 228 280 408 424 466 523 598 639 660 708 775 831 1057 1275 1473 
#module 7 size: 35 bs: 0.0010942
3 62 69 97 272 446 527 528 544 683 753 766 871 878 885 923 930 932 1055 1161 1188 1290 1306 1396 1466 1476 1504 1544 1558 1578 1585 1599 1630 1668 1679 
#module 8 size: 29 bs: 8.38272e-05
199 206 211 383 413 445 647 655 660 729 754 780 828 829 834 839 889 1026 1057 1073 1175 1273 1290 1330 1348 1374 1560 1577 1603 
#module 9 size: 28 bs: 0.000153656
130 150 207 226 354 402 406 504 514 585 612 773 805 845 938 987 1042 1088 1112 1159 1265 1339 1393 1399 1418 1538 1550 1590 
#module 10 size: 39 bs: 0.00023666
106 140 205 305 347 465 525 557 600 601 627 638 717 730 803 821 837 929 1002 1025 1052 1066 1096 1256 1259 1275 1318 1326 1362 1372 1402 1418 1419 1516 1545 1569 1635 1660 1694 
#module 11 size: 26 bs: 9.76581e-05
8 22 25 38 98 187 267 269 499 665 668 728 805 864 880 975 1039 1093 1169 1182 1310 1382 1555 1561 1587 1607 
#module 12 size: 16 bs: 1.87894e-07
18 119 190 197 259 265 352 366 368 369 430 431 437 850 1440 1575 
#module 13 size: 26 bs: 0.000183783
6 281 303 380 425 536 602 604 609 745 839 898 1000 1069 1072 1085 1378 1391 1433 1436 1447 1461 1484 1539 1669 1673 
#module 14 size: 29 bs: 1.77592e-05
43 390 476 509 510 536 543 618 623 655 732 835 995 1005 1056 1058 1076 1103 1104 1106 1127 1143 1331 1374 1401 1441 1501 1578 1584 
#module 15 size: 20 bs: 0.000930327
210 324 349 377 422 492 554 679 719 720 759 855 891 951 988 1072 1107 1154 1542 1643 
#module 16 size: 29 bs: 2.92867e-11
184 509 740 744 751 812 832 925 939 1007 1064 1097 1111 1187 1255 1257 1331 1338 1341 1390 1392 1409 1459 1472 1510 1551 1607 1622 1662 
#module 17 size: 35 bs: 3.08751e-07
170 283 330 371 565 575 646 687 714 785 787 827 846 871 928 999 1038 1056 1083 1114 1142 1155 1180 1209 1271 1303 1317 1374 1410 1451 1483 1509 1546 1597 1685 
#module 18 size: 21 bs: 2.09216e-05
81 124 167 402 493 643 753 772 811 914 936 1116 1121 1145 1240 1336 1408 1453 1474 1496 1644 
#module 19 size: 33 bs: 0.00188545
38 101 128 198 236 237 250 379 434 459 470 529 595 758 804 807 812 817 853 1020 1109 1254 1258 1301 1323 1423 1447 1483 1506 1572 1636 1646 1681 
#module 20 size: 37 bs: 0.000314654
17 33 46 76 135 196 252 312 359 373 422 594 602 632 635 667 882 924 983 987 995 996 1033 1073 1176 1190 1201 1222 1245 1316 1366 1376 1503 1519 1530 1565 1586 
#module 21 size: 38 bs: 0.00316525
85 111 115 155 168 393 474 501 503 559 674 739 781 822 943 946 956 993 1046 1104 1134 1136 1149 1162 1167 1249 1274 1294 1337 1390 1416 1417 1457 1525 1546 1566 1588 1695 
#module 22 size: 36 bs: 0.000277315
64 307 350 433 467 525 546 631 635 689 724 747 799 945 1076 1084 1093 1181 1183 1184 1194 1215 1252 1297 1303 1346 1392 1425 1430 1444 1511 1549 1555 1567 1648 1677 
#module 23 size: 30 bs: 7.2878e-06
10 34 215 256 456 460 498 513 516 558 602 624 629 649 653 674 783 808 850 900 955 1006 1017 1071 1099 1202 1251 1624 1688 1700 
#module 24 size: 38 bs: 0.000250779
90 107 223 286 295 316 387 394 395 406 414 422 452 539 635 637 640 652 664 741 832 835 895 951 967 1034 1101 1195 1237 1327 1329 1332 1443 1460 1535 1567 1579 1697 
#module 25 size: 14 bs: 9.22523e-07
13 21 117 138 160 189 195 244 263 694 945 1116 1160 1418 
#module 26 size: 21 bs: 3.65641e-06
41 256 292 327 421 470 848 867 954 1039 1041 1126 1231 1244 1312 1330 1350 1460 1587 1649 1672 
#module 27 size: 29 bs: 1.54885e-07
146 238 298 317 511 556 654 867 926 972 983 984 1072 1117 1124 1128 1163 1206 1230 1297 1324 1393 1406 1422 1425 1496 1498 1540 1683 
#module 28 size: 36 bs: 0.000436715
93 120 139 178 319 453 484 486 506 567 624 735 859 903 911 915 938 939 1019 1062 1132 1315 1318 1320 1365 1410 1467 1531 1582 1592 1596 1600 1628 1675 1686 1687 
#module 29 size: 27 bs: 6.73143e-07
173 290 397 406 545 581 645 682 732 764 815 929 935 1092 1129 1133 1179 1194 1287 1300 1369 1422 1488 1536 1594 1654 1657 
#module 30 size: 40 bs: 1.16485e-05
79 83 86 126 166 227 308 388 399 428 452 482 494 529 655 666 670 705 711 796 852 1076 1211 1239 1280 1284 1307 1314 1329 1344 1400 1413 1417 1465 1481 1494 1496 1625 1658 1664 
#module 31 size: 39 bs: 0.0038075
23 31 37 54 89 225 271 297 368 449 560 695 698 863 865 868 884 971 1055 1075 1079 1098 1102 1193 1261 1315 1356 1368 1397 1452 1458 1508 1621 1638 1642 1661 1670 1672 1684 
#module 32 size: 27 bs: 1.4566e-06
242 282 304 311 397 571 603 604 720 788 795 864 952 987 1011 1083 1120 1141 1143 1475 1480 1604 1611 1612 1637 1643 1659 
#module 33 size: 36 bs: 5.70731e-06
180 204 243 313 378 425 441 493 518 531 544 673 723 793 846 850 901 945 947 989 1044 1095 1122 1162 1243 1250 1262 1285 1377 1383 1445 1486 1571 1581 1679 1698 
#module 34 size: 19 bs: 0.000621494
158 209 275 293 410 466 570 658 662 678 713 717 792 825 991 1160 1257 1490 1648 
#module 35 size: 20 bs: 0.000249179
29 110 253 276 337 362 401 415 427 488 522 552 731 817 823 860 870 1380 1513 1606 
#module 36 size: 21 bs: 1.14979e-05
181 216 367 400 444 525 648 672 941 1003 1013 1080 1091 1125 1153 1160 1179 1180 1203 1331 1550 
#module 37 size: 30 bs: 0.00412453
75 96 123 255 385 405 446 509 549 551 559 572 610 707 714 767 772 818 846 887 937 953 959 973 1107 1311 1442 1449 1520 1604 
#module 38 size: 12 bs: 1.01388e-05
30 53 55 72 88 989 1043 1126 1146 1501 1536 1616 
#module 39 size: 19 bs: 1.16093e-06
131 145 185 264 266 270 320 331 335 392 505 642 725 842 895 1043 1257 1559 1594 
#module 40 size: 40 bs: 0.00435102
67 84 122 142 148 175 224 227 419 420 423 434 480 491 534 553 568 613 621 661 704 881 892 921 1047 1222 1235 1243 1272 1276 1305 1352 1397 1450 1455 1478 1557 1632 1639 1653 
#module 41 size: 26 bs: 9.53313e-06
108 230 417 650 736 857 862 949 991 1030 1107 1148 1212 1225 1233 1358 1377 1417 1423 1440 1457 1459 1476 1515 1536 1595 
#module 42 size: 35 bs: 0.000239566
92 179 251 341 372 443 473 489 599 693 715 826 940 966 997 1023 1037 1192 1194 1211 1219 1273 1274 1334 1415 1435 1456 1467 1469 1512 1525 1575 1585 1616 1629 
#module 43 size: 34 bs: 0.00456148
37 56 80 118 128 258 278 396 399 463 517 566 674 724 814 861 919 938 1034 1059 1116 1184 1226 1256 1269 1373 1392 1432 1463 1467 1468 1551 1618 1649 
#module 44 size: 37 bs: 8.24846e-06
91 152 174 182 310 407 524 703 733 774 805 854 875 876 933 949 950 965 1016 1067 1138 1190 1192 1216 1325 1343 1360 1361 1404 1431 1453 1502 1534 1560 1589 1683 1690 
#module 45 size: 30 bs: 0.000704589
89 144 227 258 276 374 386 452 574 622 624 691 765 830 833 847 869 953 1004 1119 1171 1178 1208 1242 1402 1424 1429 1485 1490 1507 
#module 46 size: 28 bs: 0.000135942
44 48 133 217 247 260 321 409 425 437 493 615 659 826 961 1001 1029 1100 1139 1196 1221 1227 1303 1357 1364 1396 1424 1503 
#module 47 size: 38 bs: 0.000211038
44 57 154 191 200 249 254 255 256 285 358 412 494 550 634 651 692 765 788 801 843 874 916 928 1008 1055 1086 1090 1218 1224 1233 1234 1260 1283 1432 1512 1671 1692 
#module 48 size: 38 bs: 0.00421288
95 171 199 221 274 301 357 439 533 544 575 586 604 657 720 748 806 809 840 908 949 962 1024 1101 1130 1137 1161 1165 1258 1295 1338 1345 1385 1447 1469 1526 1616 1631 
#module 49 size: 36 bs: 4.37803e-05
114 132 240 257 287 361 496 588 592 645 694 697 756 769 782 794 825 951 960 1146 1211 1292 1351 1384 1387 1390 1403 1473 1491 1524 1548 1551 1627 1657 1667 1688 
#module 50 size: 19 bs: 0.0032913
134 232 318 382 401 438 458 530 777 812 1093 1100 1167 1222 1345 1347 1495 1537 1544 
#module 51 size: 36 bs: 0.00242918
147 203 218 260 268 297 333 336 343 469 478 547 598 620 712 743 763 774 784 864 934 1036 1040 1081 1084 1158 1197 1205 1275 1371 1395 1490 1518 1537 1575 1670 
#module 52 size: 33 bs: 4.88657e-05
27 68 73 100 411 471 483 487 495 532 579 582 596 607 679 724 797 813 873 994 1060 1157 1204 1229 1268 1281 1340 1353 1363 1375 1523 1556 1579 
#module 53 size: 33 bs: 0.000689628
151 262 326 332 376 468 502 538 568 576 663 676 686 750 778 816 835 981 1009 1117 1189 1200 1274 1308 1333 1398 1492 1512 1525 1615 1669 1687 1696 
#module 54 size: 13 bs: 3.50321e-05
11 60 70 71 77 125 136 149 549 613 1247 1537 1687 
#module 55 size: 39 bs: 4.73786e-06
12 165 183 220 288 375 389 404 448 489 494 580 626 643 706 709 752 762 770 789 853 995 1050 1070 1094 1154 1288 1291 1302 1379 1404 1440 1462 1493 1531 1605 1626 1655 1656 
#module 56 size: 15 bs: 0.000128647
32 40 105 202 212 214 284 286 289 529 801 1235 1380 1404 1672 
#module 57 size: 36 bs: 0.0023201
4 104 150 172 229 329 364 429 491 548 569 688 734 820 824 886 944 966 1012 1021 1075 1154 1298 1337 1382 1420 1438 1459 1522 1527 1528 1543 1544 1601 1609 1674 
#module 58 size: 28 bs: 0.00206055
66 126 127 340 365 401 426 537 675 722 836 877 969 991 1028 1082 1135 1204 1313 1335 1388 1424 1505 1540 1560 1607 1620 1649 
#module 59 size: 36 bs: 0.000520812
19 20 51 213 300 322 342 454 573 587 619 623 645 823 825 838 863 1078 1108 1184 1217 1220 1355 1359 1388 1427 1492 1522 1532 1578 1579 1585 1602 1608 1623 1643 
#module 60 size: 34 bs: 1.15865e-05
141 219 304 490 506 625 643 715 716 753 761 772 866 888 902 922 986 1053 1144 1153 1248 1256 1358 1469 1482 1501 1524 1540 1559 1645 1650 1666 1669 1689 
#module 61 size: 26 bs: 1.09413e-05
74 418 462 472 526 718 726 810 925 953 1034 1118 1120 1290 1358 1370 1377 1382 1410 1425 1453 1497 1564 1602 1613 1693 
#module 62 size: 18 bs: 3.90493e-06
24 65 118 177 194 208 231 334 339 346 360 432 442 926 1005 1385 1483 1531 
#module 63 size: 19 bs: 1.73915e-05
28 58 63 130 159 164 222 273 363 368 447 500 542 910 1495 1513 1555 1587 1683 
#module 64 size: 31 bs: 4.37552e-06
192 241 306 438 507 541 578 580 656 723 786 802 983 989 1032 1083 1113 1168 1330 1349 1350 1372 1437 1485 1517 1591 1617 1641 1670 1691 1699 
#module 65 size: 23 bs: 2.73783e-06
294 403 475 549 614 671 684 701 844 858 894 918 959 963 1115 1152 1277 1323 1328 1381 1448 1494 1610 
#module 66 size: 37 bs: 0.000731739
128 296 344 375 394 519 540 559 611 630 702 727 755 790 909 920 976 978 985 998 1031 1048 1051 1054 1143 1161 1243 1266 1321 1454 1513 1514 1542 1583 1589 1592 1678 
#module 67 size: 36 bs: 1.31737e-05
99 129 157 186 336 370 394 451 454 461 546 589 628 801 817 867 912 964 1140 1151 1152 1282 1296 1309 1396 1397 1438 1499 1505 1521 1568 1594 1612 1614 1627 1665 
#module 68 size: 14 bs: 0.000391809
49 109 112 113 188 323 436 723 1142 1258 1361 1413 1583 1693 
#module 69 size: 31 bs: 0.0019303
162 163 169 276 299 325 412 416 512 521 562 584 593 735 791 793 893 1015 1022 1077 1087 1105 1156 1214 1247 1391 1407 1413 1554 1580 1614 
#module 70 size: 34 bs: 0.000749264
94 161 235 279 302 353 398 467 577 583 606 659 699 714 742 793 907 1049 1061 1120 1174 1190 1213 1223 1263 1273 1323 1386 1464 1471 1505 1641 1682 1688 
#module 71 size: 24 bs: 0.000695744
59 69 78 659 717 819 853 926 958 970 979 1084 1142 1182 1186 1220 1315 1338 1402 1489 1503 1552 1614 1633 
#module 72 size: 35 bs: 0.00201454
47 121 143 176 258 261 328 450 466 617 660 798 800 826 849 890 905 925 931 959 992 1035 1089 1164 1286 1329 1350 1393 1411 1473 1570 1572 1592 1619 1657 
#module 73 size: 38 bs: 0.00127564
5 15 52 116 144 155 177 247 248 356 405 477 515 535 597 616 632 641 670 681 710 757 832 904 1146 1166 1177 1191 1204 1289 1428 1434 1446 1542 1572 1589 1606 1658 
#module 74 size: 24 bs: 0.000943788
82 268 300 354 399 520 694 906 917 927 1170 1219 1236 1241 1246 1278 1297 1347 1367 1426 1439 1641 1651 1676 
#module 75 size: 20 bs: 8.46473e-05
218 384 455 491 497 521 555 771 841 1068 1100 1117 1152 1219 1264 1319 1364 1385 1405 1477 
#module 76 size: 11 bs: 0.000187187
2 14 16 39 45 580 957 1057 1111 1267 1368 
#module 77 size: 19 bs: 0.00126481
239 345 405 478 563 590 732 737 872 928 957 1043 1074 1147 1182 1210 1270 1522 1563 
#module 78 size: 29 bs: 0.00138207
9 35 246 315 391 457 680 760 779 966 1063 1162 1173 1207 1253 1267 1293 1299 1304 1361 1363 1391 1421 1457 1492 1533 1567 1593 1602 
