#module 0 size: 20 bs: 0.000228638
11 15 90 99 171 183 314 356 362 376 423 445 449 453 485 599 638 639 659 661 
#module 1 size: 15 bs: 0.00196419
13 24 39 78 102 150 217 319 458 473 567 589 601 619 631 
#module 2 size: 14 bs: 0.00218649
32 71 113 257 282 297 324 331 355 407 563 578 583 699 
#module 3 size: 22 bs: 9.6401e-05
94 105 138 185 242 275 398 413 421 466 507 553 554 556 559 599 611 614 660 674 676 696 
#module 4 size: 19 bs: 0.00102232
46 66 75 108 221 232 239 267 284 368 379 390 400 501 556 624 639 662 663 
#module 5 size: 11 bs: 0.000974192
29 106 195 280 293 302 343 371 446 454 571 
#module 6 size: 16 bs: 0.00012379
62 118 134 198 223 241 246 262 315 406 497 537 650 657 678 694 
#module 7 size: 23 bs: 0.00043812
38 55 63 107 110 111 122 179 189 204 230 316 369 384 452 475 476 487 568 634 652 693 695 
#module 8 size: 15 bs: 0.000482828
153 160 161 266 341 358 377 437 456 544 604 609 626 637 686 
#module 9 size: 25 bs: 0.00369637
34 44 74 84 210 231 339 346 348 357 361 370 419 450 488 521 531 547 559 577 606 609 632 637 655 
#module 10 size: 26 bs: 0.000525197
4 8 72 155 215 296 325 328 344 398 461 492 501 525 540 549 574 575 603 612 643 646 651 673 674 685 
#module 11 size: 19 bs: 0.000253916
59 191 193 197 312 316 323 333 412 423 424 425 431 459 477 581 610 611 613 
#module 12 size: 19 bs: 0.00367287
103 104 127 261 281 289 294 295 310 334 335 403 484 520 522 560 640 660 669 
#module 13 size: 10 bs: 4.44199e-06
83 132 149 152 177 288 350 432 511 550 
#module 14 size: 12 bs: 0.000504078
37 112 128 172 192 208 429 439 446 528 622 638 
#module 15 size: 18 bs: 0.000565606
16 25 45 57 95 275 306 333 433 442 471 473 479 519 576 587 599 607 
#module 16 size: 11 bs: 0.00281367
125 176 190 233 243 301 387 513 517 594 687 
#module 17 size: 28 bs: 0.00161348
30 31 54 65 74 166 224 237 286 309 313 383 401 447 460 461 503 509 522 542 568 590 627 633 634 636 665 667 
#module 18 size: 27 bs: 0.000904424
17 23 97 142 158 206 228 254 260 265 279 283 309 318 322 326 372 409 414 459 464 491 539 562 580 653 682 
#module 19 size: 18 bs: 0.00314545
47 108 116 129 156 320 321 329 402 416 438 481 483 496 579 598 645 663 
#module 20 size: 15 bs: 0.0018311
9 67 164 187 203 265 269 290 336 364 426 427 475 488 592 
#module 21 size: 23 bs: 0.000362129
61 91 144 147 167 178 207 219 272 286 300 327 374 404 457 461 478 515 554 612 627 656 689 
#module 22 size: 15 bs: 0.00469241
60 68 136 144 246 314 399 418 493 579 601 639 675 680 692 
#module 23 size: 14 bs: 0.0008546
123 148 200 345 354 393 435 462 523 573 586 587 631 690 
#module 24 size: 28 bs: 0.000317181
26 73 82 92 98 141 159 163 202 259 285 298 322 380 397 411 448 469 474 485 500 528 597 615 616 661 672 700 
#module 25 size: 31 bs: 0.00499563
96 110 121 126 143 205 211 225 226 229 246 310 311 351 372 395 410 415 436 467 495 503 507 518 524 527 535 536 538 561 565 
#module 26 size: 15 bs: 8.42804e-05
7 124 173 214 255 268 305 353 359 408 508 512 532 622 632 
#module 27 size: 34 bs: 0.00091
18 51 86 130 133 135 137 175 180 209 219 248 263 277 299 332 352 368 378 381 420 434 443 465 470 490 498 570 582 618 628 640 642 664 
#module 28 size: 24 bs: 0.000395633
35 56 70 120 199 218 227 234 267 274 366 473 480 482 487 524 541 558 585 590 595 600 623 683 
#module 29 size: 16 bs: 0.00450587
41 48 89 253 264 295 337 367 428 455 486 499 516 559 647 681 
#module 30 size: 72 bs: 0.0033466
19 20 88 117 119 126 140 151 154 157 165 174 182 186 236 245 250 251 258 270 289 291 292 307 308 347 349 360 372 385 386 388 389 391 417 440 444 454 458 468 489 495 504 505 506 514 526 529 535 548 552 555 557 564 566 572 584 591 608 620 624 635 649 666 668 670 673 675 677 684 688 697 
#module 31 size: 31 bs: 0.00109911
10 36 43 50 77 87 109 131 184 196 216 244 256 305 340 365 369 438 441 471 472 487 494 504 534 543 569 625 644 672 698 
#module 32 size: 18 bs: 0.00125511
249 260 302 304 330 405 530 533 545 546 596 602 613 617 626 658 671 690 
