#module 0 size: 28 bs: 0.000630641
35 47 50 99 112 161 176 184 197 218 305 353 419 440 445 481 487 540 545 561 584 613 632 651 664 673 682 695 
#module 1 size: 21 bs: 0.000755663
7 20 64 67 86 117 191 212 231 283 311 312 314 315 345 369 406 432 447 511 571 
#module 2 size: 13 bs: 0.00155504
4 43 91 95 122 126 142 180 227 248 273 487 555 
#module 3 size: 13 bs: 0.000229128
106 130 140 181 206 224 228 346 372 380 386 495 614 
#module 4 size: 20 bs: 0.00109434
1 32 36 72 75 92 102 120 182 234 290 297 299 318 352 361 416 444 573 648 
#module 5 size: 32 bs: 0.000196355
51 60 61 109 127 161 220 251 263 282 317 369 397 441 453 458 460 494 514 515 527 538 557 570 587 620 657 667 672 681 694 700 
#module 6 size: 13 bs: 3.02426e-05
23 34 39 55 68 94 98 119 132 196 197 385 641 
#module 7 size: 28 bs: 0.000423786
25 145 146 148 239 307 338 370 436 459 467 472 474 506 510 527 530 559 620 633 648 650 651 659 663 666 668 693 
#module 8 size: 30 bs: 0.003393
57 101 134 202 208 236 276 282 300 302 324 330 333 364 365 384 417 454 461 465 479 485 497 534 593 602 636 643 648 679 
#module 9 size: 37 bs: 0.000138389
3 24 89 110 121 149 156 179 185 226 256 257 284 291 298 301 376 381 399 404 427 430 442 466 496 505 548 550 560 574 591 623 640 646 688 693 699 
#module 10 size: 18 bs: 0.000131525
63 69 77 167 194 254 285 291 351 373 390 410 415 417 469 538 586 677 
#module 11 size: 31 bs: 0.000350555
66 147 151 195 219 225 232 291 293 327 328 337 384 418 431 438 443 480 495 505 516 534 543 589 610 634 655 670 682 688 693 
#module 12 size: 11 bs: 0.00125974
15 27 29 45 172 188 350 580 630 650 668 
#module 13 size: 18 bs: 0.000165603
203 310 321 348 356 357 362 392 458 468 484 523 537 586 599 627 678 688 
#module 14 size: 11 bs: 8.2035e-07
9 38 42 53 59 62 88 383 577 582 692 
#module 15 size: 26 bs: 0.00228467
41 70 93 114 157 162 197 204 255 293 309 326 378 414 424 435 503 526 527 565 569 570 581 597 668 692 
#module 16 size: 25 bs: 0.00413075
18 128 138 171 235 266 336 341 350 389 445 451 462 478 529 543 572 587 595 600 611 634 637 685 691 
#module 17 size: 33 bs: 0.00193584
79 86 96 103 218 246 253 272 274 293 331 367 396 407 413 426 458 471 484 543 552 556 558 586 624 625 626 628 646 665 676 680 687 
#module 18 size: 24 bs: 0.00351862
81 115 136 190 215 237 369 408 465 466 469 477 515 532 536 567 576 624 639 646 660 662 674 677 
#module 19 size: 27 bs: 0.00323807
84 118 137 200 214 241 285 308 319 329 354 376 382 394 405 433 456 486 513 544 545 548 595 603 630 648 668 
#module 20 size: 35 bs: 0.00124299
5 71 73 79 108 153 178 197 207 212 258 268 296 334 340 359 360 429 465 466 475 498 499 527 531 545 578 585 587 592 608 609 615 664 697 
#module 21 size: 19 bs: 0.000232304
31 54 104 144 156 158 211 240 242 249 250 261 286 339 368 391 577 601 650 
#module 22 size: 19 bs: 0.00181402
28 30 159 270 316 385 387 457 463 465 482 492 522 548 587 617 656 658 694 
#module 23 size: 27 bs: 0.000222679
8 10 71 154 189 191 212 230 240 260 358 411 417 477 491 501 507 546 554 572 581 584 631 641 652 675 682 
#module 24 size: 21 bs: 0.00130946
19 58 125 135 177 238 243 267 271 349 376 428 452 487 541 547 614 624 644 653 683 
#module 25 size: 14 bs: 7.09021e-05
6 22 78 90 160 173 280 335 451 474 512 555 586 620 
#module 26 size: 28 bs: 0.00144701
14 44 74 111 113 193 210 223 244 292 349 374 401 409 423 450 455 487 492 515 525 543 548 577 584 646 685 698 
#module 27 size: 32 bs: 0.00146979
83 85 87 129 150 163 196 278 332 334 344 375 388 405 412 447 449 474 522 524 547 555 563 567 580 601 612 614 629 654 661 686 
#module 28 size: 25 bs: 1.08549e-05
17 33 97 139 166 183 233 342 437 461 521 522 528 535 573 575 581 582 590 595 616 634 645 669 698 
#module 29 size: 26 bs: 0.000388694
21 123 137 170 229 265 279 294 306 341 367 371 381 384 385 417 434 435 448 474 517 551 553 619 649 671 
#module 30 size: 18 bs: 0.00170434
40 56 269 287 319 325 343 377 395 402 483 493 522 572 603 620 630 651 
#module 31 size: 33 bs: 0.000280466
45 46 82 116 124 164 169 191 196 221 240 261 262 295 320 368 379 420 425 470 488 490 538 564 579 595 608 647 677 684 689 692 696 
#module 32 size: 11 bs: 2.27965e-11
65 201 288 303 422 439 502 518 588 594 638 
#module 33 size: 27 bs: 0.000892821
100 155 184 214 217 218 252 277 281 289 341 363 492 500 508 520 533 546 566 567 573 584 596 618 622 650 692 
#module 34 size: 14 bs: 0.000440604
48 152 168 187 199 355 393 461 505 551 571 572 601 641 
#module 35 size: 20 bs: 0.000753814
2 174 186 192 194 205 216 247 279 385 477 489 519 570 603 607 624 664 685 698 
#module 36 size: 34 bs: 0.000716989
76 110 133 141 188 192 198 213 259 297 313 322 334 347 398 413 420 421 447 461 504 509 515 539 546 549 562 583 605 606 621 642 690 694 
#module 37 size: 18 bs: 0.00340972
26 80 165 306 366 403 405 411 420 473 495 538 547 568 571 604 608 664 
#module 38 size: 25 bs: 0.000319292
13 209 222 245 264 275 304 323 400 411 436 446 464 469 476 490 534 542 547 567 573 598 635 694 698 
