#module 0 size: 11 bs: 5.20281e-05
74 99 124 167 228 232 288 290 491 569 674 
#module 1 size: 26 bs: 0.000380313
37 80 86 121 236 256 261 280 319 335 354 379 392 397 398 426 436 473 524 564 571 591 599 609 611 635 
#module 2 size: 21 bs: 0.000472363
6 26 45 96 102 207 256 359 401 433 435 446 494 538 544 549 554 614 617 620 683 
#module 3 size: 21 bs: 0.00321341
12 15 78 130 174 196 203 206 270 289 296 298 308 363 417 459 480 512 590 603 700 
#module 4 size: 25 bs: 0.00179671
5 7 70 117 135 140 153 183 245 268 279 331 355 421 454 462 529 570 588 625 631 664 670 671 692 
#module 5 size: 17 bs: 0.000648335
39 156 257 388 490 497 502 526 536 539 567 572 614 636 654 656 687 
#module 6 size: 20 bs: 0.00320501
20 55 106 127 139 166 169 181 226 241 242 258 267 373 493 498 522 563 574 615 
#module 7 size: 16 bs: 0.000328804
58 65 66 119 145 184 220 322 329 387 442 507 565 624 629 649 
#module 8 size: 26 bs: 0.000125379
13 84 95 146 154 230 250 302 347 361 362 417 453 492 502 514 521 542 546 576 584 591 592 653 656 667 
#module 9 size: 25 bs: 0.00462878
90 126 149 174 208 279 280 291 309 315 324 333 367 420 431 434 440 451 482 518 568 621 643 680 691 
#module 10 size: 19 bs: 0.000267692
83 197 239 260 273 280 284 349 396 398 404 436 441 520 530 587 602 655 659 
#module 11 size: 23 bs: 0.000558827
26 27 33 50 73 75 81 111 142 161 225 264 283 339 377 384 402 484 520 530 641 670 697 
#module 12 size: 13 bs: 0.00124335
24 114 180 231 305 350 381 399 409 465 499 580 687 
#module 13 size: 9 bs: 0.000768744
158 172 188 192 294 538 548 558 581 
#module 14 size: 10 bs: 0.00107453
105 128 132 168 202 223 281 414 531 699 
#module 15 size: 21 bs: 4.98075e-05
3 14 52 179 245 296 310 332 358 380 382 408 412 415 431 503 505 534 623 661 686 
#module 16 size: 15 bs: 0.000104159
72 131 141 198 248 447 509 519 551 560 570 637 662 684 696 
#module 17 size: 21 bs: 0.00383853
48 54 61 137 186 197 229 243 246 325 364 399 401 440 444 475 549 596 607 638 639 
#module 18 size: 25 bs: 0.0011237
44 98 104 136 150 187 194 235 276 285 356 449 457 503 536 549 591 621 622 630 634 636 673 674 698 
#module 19 size: 21 bs: 0.00177645
111 122 139 144 200 317 343 385 406 418 437 445 463 471 478 556 575 608 619 677 678 
#module 20 size: 29 bs: 0.0042006
8 29 49 69 100 123 134 143 161 199 206 215 216 227 282 292 299 334 338 374 378 452 471 517 542 552 604 644 674 
#module 21 size: 23 bs: 0.000244348
76 103 125 170 176 214 272 317 337 352 366 384 420 429 450 456 486 501 523 532 559 600 603 
#module 22 size: 10 bs: 0.00455463
1 131 210 368 423 427 472 485 590 690 
#module 23 size: 18 bs: 0.00189231
23 62 109 120 174 192 259 287 303 312 384 389 405 501 578 612 618 640 
#module 24 size: 26 bs: 0.00498246
33 35 46 79 213 219 241 262 271 275 366 407 412 413 444 495 504 540 558 566 578 586 602 628 650 681 
#module 25 size: 23 bs: 0.00118808
129 157 178 189 200 221 295 344 346 351 355 369 375 498 523 525 555 586 613 627 644 648 676 
#module 26 size: 25 bs: 0.0022745
28 43 60 87 113 217 231 236 252 258 266 307 323 348 353 360 373 376 394 424 444 460 499 595 613 
#module 27 size: 13 bs: 2.52642e-05
9 163 233 293 328 345 370 428 468 483 603 606 669 
#module 28 size: 25 bs: 0.00265957
21 38 89 209 274 313 371 394 403 438 439 474 481 486 509 515 516 517 520 528 537 578 626 666 688 
#module 29 size: 11 bs: 0.000118846
155 175 193 265 321 340 541 553 582 601 675 
#module 30 size: 17 bs: 0.00292637
40 47 59 93 137 159 311 337 448 455 543 557 562 594 597 645 682 
#module 31 size: 15 bs: 0.0041527
4 97 115 165 171 254 372 458 461 477 497 535 540 550 644 
#module 32 size: 14 bs: 0.00276328
34 138 151 249 308 316 422 425 490 526 589 611 633 658 
#module 33 size: 28 bs: 0.00253039
17 77 78 85 88 107 118 160 195 205 261 286 342 368 383 393 409 411 430 432 469 479 488 489 515 547 563 685 
#module 34 size: 13 bs: 0.00276894
162 164 201 240 263 277 300 314 318 326 496 617 646 
#module 35 size: 21 bs: 0.000263248
11 112 190 238 247 341 400 408 452 464 475 477 478 486 515 570 573 605 615 665 679 
#module 36 size: 23 bs: 0.00352095
16 22 49 67 185 212 237 255 285 297 301 320 390 411 413 506 511 533 577 598 613 647 693 
#module 37 size: 12 bs: 7.53145e-05
36 41 204 218 330 416 508 579 628 651 689 694 
#module 38 size: 57 bs: 0.00474299
2 10 18 42 63 81 91 110 152 173 177 191 211 217 222 224 234 251 284 304 315 327 332 357 365 386 395 410 443 467 470 476 479 487 500 504 510 513 545 561 579 585 593 608 610 616 632 642 652 657 660 663 668 672 676 690 695 
