#module 0 size: 26 bs: 8.71517e-05
85 159 167 225 273 294 332 389 429 446 449 454 513 536 588 594 624 657 665 688 714 738 815 856 863 898 
#module 1 size: 31 bs: 0.000202031
5 6 33 66 168 200 226 251 258 271 284 285 305 320 350 378 408 439 471 476 478 481 701 715 733 737 742 844 859 874 883 
#module 2 size: 31 bs: 0.000269732
25 139 174 183 191 260 282 452 495 502 508 551 561 584 591 608 631 643 693 712 725 734 773 782 789 806 824 825 840 855 900 
#module 3 size: 19 bs: 1.23068e-06
9 16 202 212 214 232 247 262 274 299 300 407 426 428 451 453 584 595 649 
#module 4 size: 34 bs: 0.00154442
38 53 57 61 80 104 120 155 195 198 211 217 278 352 445 467 485 509 535 554 556 562 663 667 689 710 727 742 757 822 839 857 863 900 
#module 5 size: 33 bs: 3.09667e-06
71 82 121 190 267 276 288 289 315 320 321 377 382 383 387 480 489 495 532 533 537 601 605 628 631 692 705 785 789 833 836 849 871 
#module 6 size: 28 bs: 1.99041e-05
23 41 52 67 204 229 278 298 302 358 390 427 478 506 520 534 618 672 695 699 735 794 812 824 856 874 875 896 
#module 7 size: 36 bs: 1.25013e-06
111 147 189 230 266 343 374 390 434 445 485 521 538 546 566 610 632 702 703 716 735 743 754 770 771 781 786 788 790 800 801 812 813 834 860 862 
#module 8 size: 22 bs: 0.00013433
1 8 11 45 126 215 250 281 436 445 497 504 522 539 573 625 636 654 706 749 767 848 
#module 9 size: 39 bs: 0.000658399
26 94 107 129 144 145 183 194 207 223 255 421 422 459 532 540 577 578 614 627 636 637 639 653 666 674 684 690 701 707 740 768 796 797 808 812 821 872 882 
#module 10 size: 37 bs: 0.00039337
57 84 92 133 156 181 317 325 335 356 357 393 410 414 420 425 432 440 531 544 575 587 595 635 668 713 730 754 760 777 779 792 805 819 826 832 845 
#module 11 size: 28 bs: 0.000376037
35 44 97 102 161 275 291 376 384 391 429 486 549 550 571 605 616 646 649 732 736 750 763 784 809 841 858 900 
#module 12 size: 30 bs: 0.00102776
88 93 142 211 212 297 312 323 376 479 483 491 588 613 658 676 706 711 781 789 803 811 827 861 864 877 880 882 884 890 
#module 13 size: 28 bs: 0.000253265
3 62 106 108 123 154 166 199 210 304 326 349 558 587 661 677 679 694 728 747 762 766 778 795 874 879 893 895 
#module 14 size: 31 bs: 6.15968e-06
56 65 81 86 103 125 153 194 293 355 392 399 401 433 479 563 574 582 587 615 626 648 659 710 721 733 748 776 817 828 873 
#module 15 size: 36 bs: 0.000493559
4 48 120 220 227 239 241 261 303 326 331 347 358 396 403 418 464 499 547 565 576 581 592 597 644 670 687 691 699 726 752 753 804 865 867 876 
#module 16 size: 37 bs: 0.00109294
23 27 83 109 152 179 200 201 211 217 234 240 357 359 456 460 474 485 500 510 511 547 560 572 629 662 704 737 761 764 777 780 821 837 838 881 895 
#module 17 size: 27 bs: 0.000875857
90 101 200 227 260 317 334 354 364 380 400 471 520 560 591 599 617 630 652 662 708 778 816 838 864 878 885 
#module 18 size: 19 bs: 5.41708e-05
135 208 245 247 252 263 340 346 362 455 457 488 524 552 611 619 651 703 767 
#module 19 size: 20 bs: 9.38781e-05
18 49 95 146 151 306 341 344 413 545 565 570 571 593 612 634 638 669 703 854 
#module 20 size: 33 bs: 0.00354249
10 43 59 156 164 169 184 272 314 316 348 397 409 492 495 512 526 543 588 605 656 669 709 718 720 737 744 745 754 810 821 842 887 
#module 21 size: 37 bs: 0.000418005
30 127 162 206 253 281 313 317 328 360 368 369 372 398 417 431 438 457 507 514 568 580 592 602 603 662 671 672 679 682 729 751 787 802 823 887 897 
#module 22 size: 16 bs: 3.13486e-05
60 75 78 158 170 185 193 233 238 249 257 302 476 565 592 598 
#module 23 size: 27 bs: 0.00230529
32 54 99 110 150 157 210 265 276 294 331 370 385 391 404 440 457 477 617 693 697 718 733 752 775 778 863 
#module 24 size: 16 bs: 1.70372e-06
17 31 34 117 128 186 286 336 589 626 708 710 777 797 819 840 
#module 25 size: 38 bs: 0.00218778
20 105 140 178 196 221 244 265 296 320 325 362 364 391 416 429 430 499 525 529 564 585 607 609 620 671 680 682 719 791 803 807 819 824 844 864 889 897 
#module 26 size: 22 bs: 0.000212162
79 218 237 269 295 363 377 386 450 461 487 557 559 586 591 598 631 641 647 655 717 758 
#module 27 size: 21 bs: 0.000100325
40 81 125 131 265 366 494 530 640 649 661 700 734 762 796 797 840 848 855 869 870 
#module 28 size: 36 bs: 0.000209712
29 47 91 129 180 279 292 294 312 322 345 351 353 356 390 424 435 440 517 544 555 560 579 633 650 664 675 698 731 752 755 781 820 869 892 894 
#module 29 size: 15 bs: 0.000134509
74 87 89 137 143 163 203 356 453 517 555 796 844 882 890 
#module 30 size: 17 bs: 0.00488282
46 136 165 182 212 224 227 283 310 329 342 357 464 517 614 680 856 
#module 31 size: 34 bs: 0.00490763
76 119 160 197 242 248 260 330 337 341 355 365 405 406 419 444 464 476 542 547 548 569 583 586 632 685 741 765 767 772 774 799 803 871 
#module 32 size: 26 bs: 0.0030496
27 37 97 155 175 235 309 316 327 331 339 519 542 604 606 610 632 661 724 762 798 829 830 847 866 893 
#module 33 size: 37 bs: 0.00362798
69 70 86 96 124 144 183 187 205 268 290 314 318 319 339 361 362 376 395 419 453 456 463 465 468 482 484 490 503 596 635 718 759 835 848 886 890 
#module 34 size: 25 bs: 9.5714e-07
39 73 130 187 207 216 219 276 280 311 388 493 516 555 626 645 681 726 783 793 843 850 852 854 899 
#module 35 size: 28 bs: 0.000103904
64 68 77 108 112 114 177 222 243 278 314 428 442 515 528 584 600 617 642 696 701 726 734 746 756 836 887 897 
#module 36 size: 37 bs: 0.00154537
7 13 14 42 51 55 100 141 192 195 203 246 254 261 271 307 308 364 411 415 419 428 501 527 544 567 589 598 622 635 680 683 722 735 838 855 886 
#module 37 size: 36 bs: 9.05648e-06
2 19 50 113 116 122 173 184 209 236 259 375 379 423 437 448 458 470 473 532 571 589 610 623 673 686 699 739 769 818 831 836 853 868 888 891 
#module 38 size: 30 bs: 0.00156287
36 63 120 125 148 171 172 187 194 256 270 271 277 312 358 367 371 412 441 443 471 472 586 621 660 706 742 846 851 854 
#module 39 size: 19 bs: 0.000708078
12 58 134 213 287 301 333 338 373 456 475 541 553 671 672 693 708 869 893 
#module 40 size: 20 bs: 0.00298665
15 22 24 98 132 188 195 228 231 264 355 442 462 466 498 499 523 525 595 895 
#module 41 size: 30 bs: 0.00124153
72 115 118 138 176 207 324 338 339 377 381 394 402 447 469 479 496 505 518 520 525 590 636 669 678 682 723 814 871 886 
