#module 0 size: 20 bs: 0.000202315
1 66 358 369 372 480 490 562 577 600 615 625 635 636 740 843 920 956 1044 1264 
#module 1 size: 14 bs: 3.4705e-06
32 33 45 49 57 105 134 135 138 596 811 831 1097 1159 
#module 2 size: 14 bs: 0.00195259
2 18 34 41 46 88 108 111 133 141 177 247 645 1162 
#module 3 size: 25 bs: 0.000819904
3 55 167 176 420 477 512 530 548 551 618 619 678 702 793 823 866 871 1083 1113 1130 1138 1169 1192 1265 
#module 4 size: 14 bs: 0.000111918
4 15 28 30 56 71 85 91 99 371 618 920 933 980 
#module 5 size: 21 bs: 0.000309774
161 239 312 337 371 373 512 548 585 593 597 739 756 775 833 858 1044 1069 1090 1121 1274 
#module 6 size: 20 bs: 1.80361e-07
5 110 125 169 203 298 306 380 438 445 474 570 580 602 652 653 681 714 751 843 
#module 7 size: 13 bs: 2.17355e-05
6 8 17 22 25 36 54 67 96 341 431 651 655 
#module 8 size: 25 bs: 5.01365e-06
188 229 231 235 244 284 302 501 509 520 522 630 646 655 660 666 815 863 881 928 931 968 982 1121 1280 
#module 9 size: 15 bs: 0.000103315
7 87 123 207 326 376 396 405 431 435 472 735 1003 1036 1058 
#module 10 size: 26 bs: 4.80675e-05
109 188 197 218 259 263 305 349 363 520 584 587 608 620 627 639 746 817 829 947 969 1074 1163 1168 1174 1227 
#module 11 size: 28 bs: 0.00169475
208 233 262 273 341 367 403 464 489 491 499 504 513 517 621 692 805 811 842 864 890 900 946 971 1018 1102 1230 1300 
#module 12 size: 19 bs: 7.08856e-07
9 74 137 175 211 258 281 289 316 340 365 375 419 493 503 529 547 656 1047 
#module 13 size: 12 bs: 5.01532e-06
10 13 14 47 51 68 362 396 625 724 1090 1202 
#module 14 size: 26 bs: 0.00270749
168 214 249 362 402 442 525 527 563 592 632 707 784 816 821 835 948 952 974 1127 1128 1140 1188 1251 1293 1296 
#module 15 size: 35 bs: 2.60846e-05
117 166 225 411 423 435 467 528 544 553 555 625 665 724 779 800 819 851 906 930 953 994 996 1009 1034 1054 1056 1082 1093 1121 1136 1157 1235 1269 1283 
#module 16 size: 33 bs: 7.8397e-06
98 179 223 234 252 260 275 277 293 323 329 409 454 465 467 533 643 677 749 763 767 788 796 838 883 894 909 931 1001 1048 1058 1202 1214 
#module 17 size: 13 bs: 8.97135e-07
11 63 72 75 101 102 128 180 205 268 608 983 1205 
#module 18 size: 35 bs: 0.00479507
58 121 157 299 300 321 325 389 422 430 444 508 532 613 674 724 751 831 910 911 963 970 993 1023 1057 1060 1075 1086 1180 1197 1201 1210 1211 1229 1233 
#module 19 size: 39 bs: 0.00320594
70 117 155 167 174 264 272 333 433 473 505 510 537 588 594 604 609 628 650 707 715 732 807 847 864 980 999 1002 1072 1084 1091 1095 1126 1150 1162 1242 1257 1260 1282 
#module 20 size: 20 bs: 4.78207e-06
60 76 192 248 257 296 390 440 443 455 456 524 550 558 583 737 855 898 938 1058 
#module 21 size: 17 bs: 2.18809e-06
21 37 98 112 122 136 151 191 216 310 336 372 381 387 397 535 980 
#module 22 size: 15 bs: 0.000241734
26 118 159 236 243 304 431 463 629 698 975 1031 1088 1127 1140 
#module 23 size: 29 bs: 0.000330441
170 217 348 397 515 541 589 599 633 637 645 648 649 686 808 813 841 857 887 889 966 975 1122 1171 1181 1192 1212 1267 1292 
#module 24 size: 19 bs: 7.73495e-05
113 119 188 201 206 229 261 269 309 386 418 437 567 706 918 1088 1127 1151 1153 
#module 25 size: 32 bs: 2.7642e-05
62 343 355 377 384 446 486 493 495 515 572 603 617 629 733 768 827 828 858 863 875 891 926 1049 1071 1105 1114 1135 1165 1172 1217 1256 
#module 26 size: 16 bs: 0.000748002
29 52 59 64 82 227 228 287 293 485 599 630 644 735 967 1060 
#module 27 size: 16 bs: 0.000765248
31 83 144 173 182 212 230 247 327 430 660 725 930 1083 1173 1221 
#module 28 size: 31 bs: 7.62241e-06
142 202 280 346 416 459 527 591 622 674 679 723 730 766 814 846 869 878 908 940 1047 1055 1111 1145 1150 1158 1173 1199 1239 1271 1295 
#module 29 size: 18 bs: 0.00023121
189 200 210 242 291 328 351 366 369 388 425 461 462 476 557 725 791 1196 
#module 30 size: 15 bs: 0.0045316
35 42 43 50 92 100 158 186 224 253 254 520 672 957 1291 
#module 31 size: 35 bs: 0.0033143
44 97 154 179 181 194 241 293 399 404 412 437 450 481 488 535 557 578 644 669 689 751 782 808 834 898 1044 1069 1152 1159 1193 1208 1213 1216 1232 
#module 32 size: 37 bs: 0.000115779
86 148 193 277 295 319 355 367 428 435 468 518 642 672 708 717 727 734 757 820 845 905 932 933 945 1019 1022 1124 1173 1185 1218 1221 1248 1263 1273 1285 1290 
#module 33 size: 31 bs: 0.000544417
94 342 396 449 457 507 552 568 620 627 687 700 729 768 796 839 874 897 898 924 935 943 986 988 1009 1038 1104 1106 1112 1166 1228 
#module 34 size: 32 bs: 0.0001267
163 209 277 303 331 334 352 374 468 484 532 608 691 776 795 831 832 883 890 918 966 973 1011 1140 1162 1170 1217 1220 1231 1234 1236 1256 
#module 35 size: 17 bs: 0.000243488
80 114 131 149 162 183 195 196 283 294 364 383 510 623 630 1017 1217 
#module 36 size: 27 bs: 7.05064e-06
176 302 303 307 455 469 645 661 729 760 806 812 888 934 957 958 1007 1046 1062 1063 1089 1094 1103 1132 1151 1172 1274 
#module 37 size: 33 bs: 0.00124412
116 121 129 225 279 297 360 362 416 439 451 492 521 574 599 611 659 729 738 741 743 869 882 919 951 965 997 1078 1150 1246 1272 1273 1299 
#module 38 size: 17 bs: 5.61481e-10
73 78 126 145 152 165 222 226 255 330 332 339 385 401 410 913 1119 
#module 39 size: 32 bs: 0.000357349
95 132 193 219 266 288 391 617 646 685 694 703 744 768 778 787 821 860 896 899 949 975 979 983 1010 1042 1068 1118 1159 1205 1225 1244 
#module 40 size: 24 bs: 0.00109212
146 246 271 320 441 448 542 546 563 571 593 688 704 758 792 888 921 930 937 1036 1037 1154 1167 1192 
#module 41 size: 30 bs: 1.31884e-05
115 120 231 249 262 391 470 475 534 612 655 672 693 719 721 736 811 869 903 913 929 1008 1077 1098 1108 1139 1143 1176 1269 1285 
#module 42 size: 36 bs: 0.000792188
77 151 265 315 350 391 493 527 611 617 627 662 671 712 765 769 772 800 852 913 922 934 967 978 991 992 1036 1051 1073 1099 1151 1182 1186 1262 1264 1279 
#module 43 size: 39 bs: 0.00228577
12 40 153 166 237 244 245 250 282 302 406 439 456 458 531 545 565 664 683 783 810 854 856 868 893 954 956 996 1004 1016 1035 1047 1061 1069 1116 1134 1161 1209 1243 
#module 44 size: 37 bs: 8.0529e-05
205 274 301 313 318 369 413 429 481 498 502 601 623 631 704 711 747 766 789 790 800 815 824 860 987 989 996 1003 1033 1050 1052 1087 1134 1167 1194 1281 1294 
#module 45 size: 39 bs: 3.52774e-05
127 156 178 179 187 286 303 308 323 353 361 535 559 566 587 624 651 726 803 825 846 859 895 912 964 976 1012 1021 1043 1067 1068 1166 1175 1179 1204 1224 1278 1286 1287 
#module 46 size: 33 bs: 7.59057e-05
16 124 204 205 220 268 324 382 390 420 432 434 446 557 573 646 675 684 707 713 722 759 820 904 925 1016 1027 1065 1080 1090 1092 1149 1295 
#module 47 size: 27 bs: 1.37077e-05
204 229 256 341 384 420 561 634 640 690 735 748 752 770 796 802 849 855 877 940 1005 1016 1148 1160 1249 1269 1277 
#module 48 size: 25 bs: 0.00428425
156 171 172 301 384 395 471 485 641 667 710 725 791 850 905 915 937 960 1006 1073 1107 1155 1178 1203 1207 
#module 49 size: 23 bs: 2.9381e-06
107 266 268 285 311 427 611 629 644 662 670 786 801 826 956 977 1031 1083 1134 1166 1226 1253 1254 
#module 50 size: 28 bs: 9.93587e-05
93 98 147 193 295 368 394 434 454 467 478 479 496 511 663 731 861 873 902 907 959 974 976 1024 1065 1097 1119 1195 
#module 51 size: 22 bs: 0.00163845
19 48 251 356 482 616 656 662 674 732 804 822 855 957 976 1023 1059 1115 1137 1261 1275 1278 
#module 52 size: 32 bs: 2.53115e-06
20 104 378 421 426 472 483 536 539 561 568 642 656 836 865 885 983 1015 1071 1100 1105 1117 1142 1164 1167 1200 1221 1241 1250 1264 1270 1284 
#module 53 size: 30 bs: 0.000282085
143 184 221 335 359 460 505 587 680 766 770 780 797 799 880 901 937 967 1009 1023 1065 1068 1097 1101 1131 1136 1139 1187 1199 1291 
#module 54 size: 32 bs: 0.000355613
151 215 230 290 367 389 494 500 516 523 596 606 607 610 618 642 651 697 710 718 745 771 872 879 929 941 944 1001 1085 1089 1144 1205 
#module 55 size: 33 bs: 0.000252168
23 333 345 379 407 414 452 456 487 512 526 538 595 616 620 647 654 764 853 860 876 936 962 972 1020 1030 1053 1088 1089 1109 1120 1129 1141 
#module 56 size: 13 bs: 2.25651e-05
24 38 53 61 90 345 463 483 596 635 843 905 1200 
#module 57 size: 36 bs: 3.59224e-06
81 139 150 333 397 398 447 463 540 605 696 732 742 755 762 773 785 801 848 865 914 917 920 923 950 985 1029 1045 1060 1146 1153 1176 1237 1238 1276 1289 
#module 58 size: 23 bs: 0.00119711
40 95 155 199 213 372 432 616 638 657 701 709 830 839 883 974 1000 1031 1070 1096 1147 1191 1278 
#module 59 size: 34 bs: 0.000217509
130 160 232 322 338 357 430 437 472 483 485 515 532 543 676 770 815 839 846 862 884 921 966 990 1017 1028 1076 1123 1184 1245 1247 1252 1258 1283 
#module 60 size: 34 bs: 0.00458323
27 84 140 164 240 313 354 392 424 466 500 542 698 791 801 809 813 818 833 921 942 973 984 1017 1071 1105 1110 1156 1222 1240 1255 1259 1266 1291 
#module 61 size: 31 bs: 0.000129809
79 100 167 190 247 267 276 281 390 623 626 658 695 704 754 813 844 864 865 886 918 961 981 998 1032 1054 1066 1190 1285 1287 1298 
#module 62 size: 21 bs: 0.00291352
106 266 370 400 407 436 453 506 542 561 575 774 844 890 969 1001 1003 1073 1119 1153 1199 
#module 63 size: 32 bs: 2.66211e-05
103 281 408 454 497 510 554 560 569 590 710 720 798 837 840 858 863 867 916 931 939 940 955 1054 1081 1133 1183 1196 1200 1223 1268 1288 
#module 64 size: 29 bs: 3.7136e-05
147 198 278 323 347 371 452 455 505 516 519 568 579 586 593 614 673 682 705 716 750 753 821 929 934 1176 1202 1206 1297 
#module 65 size: 21 bs: 4.99978e-06
270 317 404 416 446 452 516 549 576 777 781 844 888 1025 1039 1109 1139 1198 1219 1274 1295 
#module 66 size: 31 bs: 0.000729062
238 292 314 344 393 415 417 514 556 564 581 582 598 660 699 728 764 820 927 933 973 995 1013 1026 1064 1079 1125 1136 1172 1177 1273 
#module 67 size: 20 bs: 0.000188531
185 479 548 565 668 744 761 764 794 808 870 892 1014 1040 1041 1109 1189 1196 1215 1287 
