#module 0 size: 14 bs: 4.16566e-05
3 7 9 10 13 16 19 24 36 43 108 121 169 281 
#module 1 size: 32 bs: 0.00113356
17 67 69 72 96 99 105 109 111 116 125 127 135 140 173 177 178 182 184 185 202 210 231 237 242 259 268 280 284 290 294 300 
#module 2 size: 17 bs: 0.000260031
4 8 12 18 33 34 49 63 65 78 105 108 121 174 212 250 261 
#module 3 size: 15 bs: 0.00310671
32 42 88 120 137 138 144 146 161 179 193 221 286 294 297 
#module 4 size: 35 bs: 0.0013203
11 23 27 52 64 71 76 81 86 94 112 142 165 167 169 170 186 187 189 199 212 213 214 218 221 223 225 233 235 250 261 268 272 279 293 
#module 5 size: 26 bs: 0.000836694
25 38 74 100 113 148 151 168 172 174 183 203 205 208 215 224 229 243 245 252 254 265 276 278 282 296 
#module 6 size: 19 bs: 4.76848e-05
21 22 39 70 74 109 115 117 122 130 143 154 155 162 168 205 261 281 298 
#module 7 size: 34 bs: 0.00126126
20 28 31 53 59 60 72 79 89 90 93 98 107 124 133 136 145 163 169 175 176 191 192 194 205 216 226 240 247 251 262 263 271 287 
#module 8 size: 18 bs: 0.00034479
1 2 15 46 62 77 85 101 102 110 117 200 206 229 231 242 268 276 
#module 9 size: 32 bs: 0.000221072
41 58 68 108 116 129 134 147 168 183 189 190 196 197 201 207 222 232 234 239 241 244 249 253 258 264 271 273 276 283 292 297 
#module 10 size: 27 bs: 0.000326949
54 56 61 73 82 83 84 87 89 97 103 106 126 131 152 156 157 163 198 204 220 236 256 267 271 275 289 
#module 11 size: 13 bs: 1.71279e-06
29 37 44 45 47 50 55 104 180 212 217 234 298 
#module 12 size: 25 bs: 0.00014988
6 26 35 66 75 80 92 119 123 132 139 160 166 181 188 189 196 219 222 229 238 246 255 274 291 
#module 13 size: 22 bs: 0.000170983
30 114 116 118 128 141 159 163 164 177 180 196 204 206 209 223 224 227 277 288 292 298 
#module 14 size: 35 bs: 0.000905402
5 14 40 48 57 59 91 95 107 121 137 149 150 153 158 165 171 195 200 206 211 222 223 228 230 246 248 257 260 266 269 270 285 295 299 
