#module 0 size: 36 bs: 2.31661e-05
8 10 13 31 43 54 121 141 159 196 198 216 249 281 320 327 341 347 358 366 397 399 429 451 459 464 468 474 492 508 525 532 565 629 653 693 
#module 1 size: 36 bs: 0.000530784
22 48 78 97 120 131 143 170 203 210 224 225 352 372 380 399 431 452 457 487 499 528 530 538 556 559 577 613 622 626 637 639 649 660 663 681 
#module 2 size: 20 bs: 4.54911e-05
92 101 104 105 119 186 209 246 261 267 276 283 287 392 495 544 576 594 685 695 
#module 3 size: 18 bs: 0.00222687
33 49 79 149 204 219 227 230 253 281 358 385 545 557 582 645 695 699 
#module 4 size: 12 bs: 0.000534257
82 122 211 238 282 294 331 363 396 590 607 668 
#module 5 size: 21 bs: 0.000128331
4 83 86 98 124 177 210 235 284 333 360 376 390 417 448 456 474 508 509 537 538 
#module 6 size: 21 bs: 0.0010845
15 16 76 115 128 215 229 244 338 365 407 408 465 501 503 518 533 538 578 609 629 
#module 7 size: 15 bs: 0.00367124
20 74 80 88 109 114 117 210 304 402 430 486 578 621 656 
#module 8 size: 30 bs: 0.0042943
17 47 70 95 189 208 231 240 284 305 336 349 373 386 418 430 442 447 460 507 516 562 592 601 615 618 652 681 699 700 
#module 9 size: 33 bs: 0.000131817
6 17 44 96 127 144 148 152 165 192 201 217 223 296 298 300 303 326 391 397 429 433 444 454 488 555 560 574 576 599 605 686 690 
#module 10 size: 28 bs: 0.00077552
56 137 138 140 153 158 168 190 315 339 345 379 458 511 514 529 581 585 588 604 623 643 644 651 656 665 689 697 
#module 11 size: 30 bs: 0.000349564
41 42 96 103 111 124 163 170 242 251 282 285 294 301 341 378 423 427 428 431 437 439 442 491 567 571 588 607 633 696 
#module 12 size: 14 bs: 8.74955e-05
14 27 57 85 123 167 231 255 383 495 506 521 525 685 
#module 13 size: 34 bs: 0.000432187
3 34 51 59 104 139 155 164 205 209 218 263 280 296 318 329 361 410 419 436 438 446 484 494 512 519 523 534 535 551 564 571 575 650 
#module 14 size: 13 bs: 0.00140103
11 29 35 36 40 55 60 147 179 303 387 532 539 
#module 15 size: 21 bs: 0.00278712
7 25 77 84 262 283 287 309 345 429 490 493 506 518 543 565 620 651 672 675 684 
#module 16 size: 21 bs: 0.00157083
5 71 89 100 130 167 194 220 222 308 316 327 334 365 445 449 547 594 620 670 700 
#module 17 size: 28 bs: 0.000988432
195 206 251 268 293 297 335 336 340 356 361 375 389 414 415 420 454 504 507 508 529 542 547 594 642 661 671 679 
#module 18 size: 28 bs: 1.33455e-05
21 26 87 110 112 132 149 150 160 194 198 241 302 306 323 376 377 411 466 488 526 539 570 578 635 649 669 675 
#module 19 size: 26 bs: 0.000459164
53 81 90 91 207 251 254 279 287 300 308 313 344 395 411 432 440 445 474 475 480 509 596 607 621 683 
#module 20 size: 26 bs: 2.5192e-05
24 75 135 212 255 266 286 288 292 332 333 409 447 467 472 488 515 526 550 558 569 608 611 640 664 692 
#module 21 size: 17 bs: 0.00474743
30 45 58 67 73 102 153 258 266 330 336 369 371 582 586 623 676 
#module 22 size: 31 bs: 0.00141445
1 50 68 118 143 183 256 291 325 330 350 392 426 443 447 454 455 461 486 497 536 563 564 586 588 603 620 625 630 650 684 
#module 23 size: 27 bs: 0.000784025
64 97 134 136 147 156 186 221 231 248 273 275 314 324 359 381 425 449 453 458 490 498 502 537 553 595 682 
#module 24 size: 25 bs: 0.000553549
44 61 65 69 127 139 213 312 323 328 392 421 431 485 513 524 529 606 609 617 619 626 666 676 686 
#module 25 size: 33 bs: 8.74171e-05
84 93 113 143 154 182 277 290 310 322 328 345 357 371 375 411 435 460 531 532 547 568 569 572 580 586 596 655 680 683 685 687 700 
#module 26 size: 39 bs: 0.00301092
19 89 99 178 219 239 257 271 282 299 306 319 330 333 354 362 386 393 402 404 444 471 473 479 489 496 522 537 539 555 561 565 569 573 593 602 615 652 662 
#module 27 size: 17 bs: 0.000118766
38 46 171 187 192 198 266 343 395 400 402 416 450 609 621 697 699 
#module 28 size: 26 bs: 0.000159863
129 135 142 144 162 172 202 209 265 304 314 337 368 403 434 478 527 545 552 557 563 579 623 624 670 698 
#module 29 size: 30 bs: 0.00159235
12 179 228 232 264 274 297 359 365 384 388 422 440 469 510 511 548 557 600 602 615 629 638 647 648 658 670 683 695 697 
#module 30 size: 24 bs: 5.60186e-05
63 107 146 151 153 184 199 234 269 317 342 355 367 382 398 505 558 587 589 590 614 633 655 677 
#module 31 size: 25 bs: 0.00418814
72 108 145 161 191 193 233 289 295 323 377 397 424 425 437 458 473 540 564 576 647 651 654 675 688 
#module 32 size: 22 bs: 8.12702e-05
2 66 134 237 247 249 284 307 371 377 395 462 470 476 500 522 587 634 649 674 681 691 
#module 33 size: 30 bs: 3.87932e-05
18 23 28 37 52 94 96 157 181 185 245 252 405 412 430 437 463 477 483 486 494 511 555 558 589 598 631 641 645 668 
#module 34 size: 34 bs: 0.000725242
32 70 86 125 173 180 197 214 220 224 226 236 281 296 321 370 374 378 387 422 441 444 495 554 566 587 589 612 616 628 635 646 650 655 
#module 35 size: 20 bs: 0.000227615
174 175 193 194 200 215 220 311 350 351 358 394 406 427 445 456 482 582 596 645 
#module 36 size: 32 bs: 0.000196241
62 133 168 188 243 248 250 260 275 341 348 353 373 386 427 449 481 490 517 526 541 549 551 610 627 633 635 636 678 684 688 694 
#module 37 size: 31 bs: 0.000137409
39 106 116 125 166 176 213 236 272 278 308 309 364 383 401 413 442 494 506 507 521 522 544 563 584 591 626 656 658 662 667 
#module 38 size: 32 bs: 0.000602099
126 154 169 192 217 259 270 295 346 373 375 422 425 440 460 518 520 544 546 583 597 602 632 652 654 657 658 659 668 673 682 688 
