#module 0 size: 21 bs: 4.7196e-101
1 3 18 23 43 57 60 100 134 135 187 200 265 275 304 365 371 380 392 393 453 
#module 1 size: 21 bs: 2.19483e-101
6 27 44 73 144 156 175 231 248 276 283 288 299 309 324 343 351 352 358 360 460 
#module 2 size: 15 bs: 6.08586e-101
2 20 26 34 35 42 47 51 58 65 96 117 119 120 137 
#module 3 size: 31 bs: 5.31158e-101
64 84 92 123 138 160 166 177 203 219 257 298 332 368 377 383 385 387 439 447 457 464 466 487 545 555 589 597 613 630 674 
#module 4 size: 33 bs: 1.16757e-101
86 146 165 179 184 191 197 204 217 245 262 270 302 310 328 375 403 428 440 451 489 501 502 513 553 557 562 627 640 651 665 670 680 
#module 5 size: 36 bs: 1.11022e-16
4 9 16 19 52 56 63 103 130 139 161 240 260 290 293 313 316 366 399 409 420 432 435 446 482 494 497 528 539 542 570 576 621 622 625 666 
#module 6 size: 36 bs: 9.93007e-101
37 39 46 49 68 95 116 164 229 239 273 280 388 404 408 413 426 430 445 496 517 535 540 547 556 564 566 574 599 606 617 634 644 673 695 696 
#module 7 size: 28 bs: 1.83854e-101
29 88 94 99 104 110 112 167 169 195 294 312 334 414 422 442 444 469 477 480 488 510 521 532 598 629 632 658 
#module 8 size: 36 bs: 6.37656e-101
5 8 10 13 50 76 118 222 235 236 249 271 274 287 308 322 356 372 381 406 421 424 475 509 515 526 596 603 633 661 664 677 679 683 689 694 
#module 9 size: 28 bs: 1.41402e-101
11 22 40 66 71 77 89 90 98 122 192 226 291 311 321 341 374 461 471 518 530 572 582 636 639 643 663 685 
#module 10 size: 26 bs: 8.81527e-101
15 106 128 155 194 227 256 263 323 329 331 339 342 355 357 492 500 504 506 524 541 546 568 569 650 653 
#module 11 size: 19 bs: 8.48152e-101
7 25 32 45 93 105 125 142 183 186 212 230 234 251 279 297 354 361 362 
#module 12 size: 31 bs: 1.11022e-16
14 101 109 124 127 152 172 205 223 259 307 327 336 340 378 389 395 429 458 463 476 516 551 559 560 611 614 623 635 669 691 
#module 13 size: 23 bs: 9.72133e-101
30 67 140 185 254 282 315 317 345 350 401 418 450 456 490 498 519 544 561 585 594 626 681 
#module 14 size: 34 bs: 8.69572e-101
54 87 111 115 121 147 168 198 206 210 216 225 232 242 243 284 285 301 305 333 347 369 382 396 397 405 411 452 499 533 595 648 656 676 
#module 15 size: 37 bs: 8.29269e-101
12 36 70 78 108 126 154 176 181 213 224 252 258 281 303 353 376 410 416 436 437 443 465 467 495 511 523 531 543 554 571 578 590 608 678 692 698 
#module 16 size: 25 bs: 4.63342e-101
61 79 83 97 102 202 221 272 289 319 346 391 400 503 522 529 565 586 587 600 615 618 619 631 655 
#module 17 size: 36 bs: 5.54854e-101
17 24 31 72 85 163 173 180 207 211 233 237 238 250 266 268 278 394 462 481 493 507 520 525 580 602 605 620 624 646 657 660 671 672 687 699 
#module 18 size: 39 bs: 2.98792e-101
33 91 114 133 143 145 150 153 158 162 189 199 201 269 296 320 390 402 419 423 454 472 485 491 505 538 552 558 567 592 607 609 612 628 642 649 688 690 700 
#module 19 size: 40 bs: 2.3514e-101
21 48 55 141 193 209 218 247 253 261 264 295 300 337 338 367 407 417 425 427 433 434 438 441 449 470 483 484 486 527 536 537 548 549 583 638 641 652 675 686 
#module 20 size: 29 bs: 3.42058e-101
53 59 74 107 151 171 190 208 228 244 255 267 306 314 335 349 364 370 386 448 459 563 581 584 591 593 662 668 697 
#module 21 size: 38 bs: 9.86198e-101
41 81 129 131 132 149 159 170 188 214 215 220 241 286 292 326 330 344 359 363 412 415 455 473 478 514 573 575 577 579 610 616 637 645 647 654 667 684 
#module 22 size: 38 bs: 5.45476e-101
28 38 62 69 75 80 82 113 136 148 157 174 178 182 196 246 277 318 325 348 373 379 384 398 431 468 474 479 508 512 534 550 588 601 604 659 682 693 
